JobID,NCPUS,NNodes,Submit,Start,End,ElapsedRaw,State
5312341,756,21,1703688808,1703987306,1704129658,142352,COMPLETED
5312508,576,16,1703760335,1704072737,1704117631,44894,COMPLETED
5312509,576,16,1703760335,1704072737,1704119994,47257,COMPLETED
5312510,576,16,1703760335,1704117633,1704159709,42076,COMPLETED
5312766,756,21,1703858644,1704129660,1704277541,147881,COMPLETED
5312850_12,32,1,1703931144,1703931145,1704190353,259208,TIMEOUT
5313029_10,32,1,1704024773,1704024773,1704085356,60583,COMPLETED
5313029_11,32,1,1704024773,1704024773,1704086119,61346,COMPLETED
5313029_12,32,1,1704024773,1704024773,1704080850,56077,COMPLETED
5313029_1,32,1,1704024773,1704024773,1704074265,49492,COMPLETED
5313029_2,32,1,1704024773,1704024773,1704083640,58867,COMPLETED
5313029_3,32,1,1704024773,1704024773,1704091104,66331,COMPLETED
5313029_4,32,1,1704024773,1704024773,1704092819,68046,COMPLETED
5313029_5,32,1,1704024773,1704024773,1704085377,60604,COMPLETED
5313029_6,32,1,1704024773,1704024773,1704085613,60840,COMPLETED
5313029_7,32,1,1704024773,1704024773,1704090456,65683,COMPLETED
5313029_8,32,1,1704024773,1704024773,1704088174,63401,COMPLETED
5313029_9,32,1,1704024773,1704024773,1704079101,54328,COMPLETED
5313041,756,21,1704024797,1704024800,1704176064,151264,COMPLETED
5313042,756,21,1704024820,1704277542,1704424954,147412,COMPLETED
5313047,288,8,1704027086,1704027086,1704372711,345625,TIMEOUT
5313048_10,32,1,1704027351,1704027352,1704091702,64350,COMPLETED
5313048_11,32,1,1704027351,1704027352,1704088778,61426,COMPLETED
5313048_12,32,1,1704027351,1704027352,1704082213,54861,COMPLETED
5313048_1,32,1,1704027351,1704027352,1704087838,60486,COMPLETED
5313048_2,32,1,1704027351,1704027352,1704086479,59127,COMPLETED
5313048_3,32,1,1704027351,1704027352,1704086258,58906,COMPLETED
5313048_4,32,1,1704027351,1704027352,1704093056,65704,COMPLETED
5313048_5,32,1,1704027351,1704027352,1704087484,60132,COMPLETED
5313048_6,32,1,1704027351,1704027352,1704084358,57006,COMPLETED
5313048_7,32,1,1704027351,1704027352,1704089620,62268,COMPLETED
5313048_8,32,1,1704027351,1704027352,1704088413,61061,COMPLETED
5313048_9,32,1,1704027351,1704027352,1704086765,59413,COMPLETED
5313062_10,32,1,1704028174,1704028175,1704100575,72400,COMPLETED
5313062_11,32,1,1704028174,1704028175,1704100316,72141,COMPLETED
5313062_12,32,1,1704028174,1704028175,1704096523,68348,COMPLETED
5313062_1,32,1,1704028174,1704028175,1704099023,70848,COMPLETED
5313062_2,32,1,1704028174,1704028175,1704101297,73122,COMPLETED
5313062_3,32,1,1704028174,1704028175,1704098209,70034,COMPLETED
5313062_4,32,1,1704028174,1704028175,1704096595,68420,COMPLETED
5313062_5,32,1,1704028174,1704028175,1704079529,51354,COMPLETED
5313062_6,32,1,1704028174,1704028175,1704087706,59531,COMPLETED
5313062_7,32,1,1704028174,1704028175,1704097666,69491,COMPLETED
5313062_8,32,1,1704028174,1704028175,1704103439,75264,COMPLETED
5313062_9,32,1,1704028174,1704028175,1704103811,75636,COMPLETED
5313077_10,32,1,1704028381,1704028381,1704088374,59993,COMPLETED
5313077_11,32,1,1704028381,1704028381,1704112341,83960,COMPLETED
5313077_12,32,1,1704028381,1704028381,1704114053,85672,COMPLETED
5313077_1,32,1,1704028381,1704028381,1704115500,87119,COMPLETED
5313077_2,32,1,1704028381,1704028381,1704100414,72033,COMPLETED
5313077_3,32,1,1704028381,1704028381,1704103199,74818,COMPLETED
5313077_4,32,1,1704028381,1704028381,1704109054,80673,COMPLETED
5313077_5,32,1,1704028381,1704028381,1704104813,76432,COMPLETED
5313077_6,32,1,1704028381,1704028381,1704094775,66394,COMPLETED
5313077_7,32,1,1704028381,1704028381,1704101091,72710,COMPLETED
5313077_8,32,1,1704028381,1704028381,1704102270,73889,COMPLETED
5313077_9,32,1,1704028381,1704028381,1704107730,79349,COMPLETED
5313092,72,2,1704030738,1704030740,1704110578,79838,FAILED
5313144,24,1,1704077369,1704077370,1704109356,31986,COMPLETED
5313145,24,1,1704077464,1704077465,1704111251,33786,COMPLETED
5313146,252,7,1704082911,1704082911,1704402525,319614,FAILED
5313147,252,7,1704083366,1704083366,1704378008,294642,FAILED
5313148,252,7,1704083503,1704083503,1704380672,297169,FAILED
5313149,252,7,1704083567,1704083567,1704371748,288181,FAILED
5313150,252,7,1704083923,1704083923,1704370968,287045,FAILED
5313151,72,2,1704106563,1704106563,1704176760,70197,COMPLETED
5313152,4,1,1704110767,1704110768,1704118214,7446,FAILED
5313153,72,2,1704110912,1704110913,1704165072,54159,FAILED
5313154,36,1,1704111276,1704111277,1704111903,626,COMPLETED
5313155,36,1,1704111527,1704111527,1704111662,135,CANCELLED by 7504
5313156,36,1,1704111531,1704111532,1704111660,128,CANCELLED by 7504
5313157,36,1,1704111681,1704111681,1704111905,224,FAILED
5313158,36,1,1704111795,1704111796,1704113818,2022,COMPLETED
5313160,144,4,1704116684,1704116684,1704116962,278,CANCELLED by 13261
5313161,36,1,1704117939,1704117940,1704161162,43222,TIMEOUT
5313162,144,4,1704118028,1704118028,1704204454,86426,TIMEOUT
5313163,144,4,1704118028,1704118028,1704204454,86426,TIMEOUT
5313164,144,4,1704118028,1704118028,1704204454,86426,TIMEOUT
5313165,144,4,1704118028,1704118032,1704202666,84634,FAILED
5313166,144,4,1704118028,1704118032,1704204454,86422,TIMEOUT
5313167,144,4,1704118028,1704118032,1704203518,85486,FAILED
5313168,144,4,1704118028,1704118032,1704204454,86422,TIMEOUT
5313169,144,4,1704118028,1704118032,1704204454,86422,TIMEOUT
5313170,144,4,1704118028,1704118032,1704204454,86422,TIMEOUT
5313171,144,4,1704118089,1704118090,1704201881,83791,FAILED
5313172,144,4,1704118089,1704118090,1704203749,85659,FAILED
5313173,144,4,1704118089,1704118090,1704203162,85072,FAILED
5313174,144,4,1704118089,1704118090,1704204514,86424,TIMEOUT
5313175,144,4,1704118091,1704118094,1704204514,86420,TIMEOUT
5313176,144,4,1704118091,1704118094,1704204512,86418,FAILED
5313177,144,4,1704119204,1704119205,1704128777,9572,FAILED
5313179,144,4,1704119205,1704119205,1704128916,9711,FAILED
5313182,144,4,1704119205,1704119209,1704129080,9871,FAILED
5313183,144,4,1704119205,1704119209,1704128176,8967,FAILED
5313178,144,4,1704119205,1704119205,1704129465,10260,FAILED
5313180,144,4,1704119205,1704119205,1704139088,19883,CANCELLED by 10408
5313181,144,4,1704119205,1704119209,1704129444,10235,FAILED
5313184,144,4,1704119205,1704119209,1704135286,16077,FAILED
5313185,144,4,1704119206,1704119209,1704127115,7906,FAILED
5313186,144,4,1704119206,1704119209,1704127570,8361,FAILED
5313187,144,4,1704119206,1704119209,1704129060,9851,FAILED
5313194,144,4,1704119530,None,1704139565,0,CANCELLED by 10408
5313195,144,4,1704119530,None,1704139565,0,CANCELLED by 10408
5313196,144,4,1704119530,None,1704139565,0,CANCELLED by 10408
5313197,144,4,1704119530,None,1704139565,0,CANCELLED by 10408
5313198,144,4,1704119530,None,1704139565,0,CANCELLED by 10408
5313199,144,4,1704119530,None,1704139565,0,CANCELLED by 10408
5313200,144,4,1704119530,None,1704139565,0,CANCELLED by 10408
5313201,144,4,1704119530,None,1704139565,0,CANCELLED by 10408
5313202,144,4,1704119530,None,1704139565,0,CANCELLED by 10408
5313203,144,4,1704119530,None,1704139565,0,CANCELLED by 10408
5313204,144,4,1704119530,None,1704139565,0,CANCELLED by 10408
5313205,144,4,1704119530,None,1704139565,0,CANCELLED by 10408
5313206,144,4,1704119530,None,1704139565,0,CANCELLED by 10408
5313207,144,4,1704119530,None,1704139565,0,CANCELLED by 10408
5313208,144,4,1704119530,None,1704139565,0,CANCELLED by 10408
5313193,144,4,1704119530,1704135683,1704139565,3882,CANCELLED by 10408
5313188,144,4,1704119530,1704119530,1704139565,20035,CANCELLED by 10408
5313189,144,4,1704119530,1704119995,1704135682,15687,FAILED
5313190,144,4,1704119530,1704119995,1704139565,19570,CANCELLED by 10408
5313191,144,4,1704119530,1704119995,1704139565,19570,CANCELLED by 10408
5313192,144,4,1704119530,1704119995,1704139565,19570,CANCELLED by 10408
5313209,144,4,1704119531,None,1704139565,0,CANCELLED by 10408
5313210,144,4,1704119531,None,1704139565,0,CANCELLED by 10408
5313211,144,4,1704119531,None,1704139565,0,CANCELLED by 10408
5313212,144,4,1704119531,None,1704139565,0,CANCELLED by 10408
5313213,144,4,1704119531,None,1704139565,0,CANCELLED by 10408
5313214,144,4,1704119531,None,1704139565,0,CANCELLED by 10408
5313215,144,4,1704119531,None,1704139565,0,CANCELLED by 10408
5313216,144,4,1704119531,None,1704139565,0,CANCELLED by 10408
5313217,144,4,1704119531,None,1704139565,0,CANCELLED by 10408
5313218,144,4,1704119531,None,1704139565,0,CANCELLED by 10408
5313219,144,4,1704119531,None,1704139565,0,CANCELLED by 10408
5313220,144,4,1704119531,None,1704139565,0,CANCELLED by 10408
5313221,144,4,1704119531,None,1704139565,0,CANCELLED by 10408
5313222,144,4,1704119531,None,1704139565,0,CANCELLED by 10408
5313223,144,4,1704119531,None,1704139565,0,CANCELLED by 10408
5313224,144,4,1704119531,None,1704139565,0,CANCELLED by 10408
5313225,144,4,1704119531,None,1704139565,0,CANCELLED by 10408
5313226,144,4,1704119531,None,1704139565,0,CANCELLED by 10408
5313227,144,4,1704119531,None,1704139565,0,CANCELLED by 10408
5313228,144,4,1704119531,None,1704139565,0,CANCELLED by 10408
5313229,144,4,1704119531,None,1704139565,0,CANCELLED by 10408
5313230,144,4,1704119532,None,1704139565,0,CANCELLED by 10408
5313231,144,4,1704119532,None,1704139565,0,CANCELLED by 10408
5313232,144,4,1704119532,None,1704139565,0,CANCELLED by 10408
5313233,144,4,1704119532,None,1704139565,0,CANCELLED by 10408
5313234,144,4,1704119532,None,1704139565,0,CANCELLED by 10408
5313235,144,4,1704119532,None,1704139565,0,CANCELLED by 10408
5313236,144,4,1704119532,None,1704139565,0,CANCELLED by 10408
5313237,144,4,1704119532,None,1704139565,0,CANCELLED by 10408
5313238,144,4,1704119532,None,1704139565,0,CANCELLED by 10408
5313239,36,1,1704122056,1704122057,1704122457,400,COMPLETED
5313241,36,1,1704122941,1704122942,1704123310,368,COMPLETED
5313242,36,1,1704123634,1704123635,1704124013,378,COMPLETED
5313248,36,1,1704133844,1704133845,1704133866,21,FAILED
5313249,36,1,1704134642,1704134642,1704134947,305,COMPLETED
5313250,144,4,1704135077,1704135077,1704137825,2748,COMPLETED
5313251,36,1,1704135161,1704135162,1704135461,299,COMPLETED
5313252,36,1,1704135777,1704135778,1704136081,303,COMPLETED
5313254,144,4,1704139188,1704139189,1704139210,21,CANCELLED by 10408
5313255,144,4,1704139188,1704139189,1704139210,21,CANCELLED by 10408
5313256,144,4,1704139188,1704139189,1704139210,21,CANCELLED by 10408
5313257,144,4,1704139188,1704139189,1704139210,21,CANCELLED by 10408
5313258,144,4,1704139188,1704139189,1704139210,21,CANCELLED by 10408
5313259,144,4,1704139188,1704139189,1704139210,21,CANCELLED by 10408
5313260,144,4,1704139188,1704139189,1704139210,21,CANCELLED by 10408
5313261,144,4,1704139188,1704139189,1704139210,21,CANCELLED by 10408
5313262,144,4,1704139188,1704139189,1704139210,21,CANCELLED by 10408
5313263,144,4,1704139188,1704139189,1704139210,21,CANCELLED by 10408
5313264,144,4,1704139188,1704139189,1704139210,21,CANCELLED by 10408
5313265,144,4,1704139188,1704139189,1704139210,21,CANCELLED by 10408
5313266,144,4,1704139188,1704139189,1704139210,21,CANCELLED by 10408
5313267,144,4,1704139188,1704139189,1704139210,21,CANCELLED by 10408
5313268,144,4,1704139188,1704139189,1704139210,21,CANCELLED by 10408
5313269,144,4,1704139188,1704139189,1704139210,21,CANCELLED by 10408
5313270,144,4,1704139188,1704139189,1704139210,21,CANCELLED by 10408
5313276,144,4,1704139189,None,1704139210,0,CANCELLED by 10408
5313277,144,4,1704139189,None,1704139210,0,CANCELLED by 10408
5313278,144,4,1704139189,None,1704139210,0,CANCELLED by 10408
5313279,144,4,1704139189,None,1704139210,0,CANCELLED by 10408
5313280,144,4,1704139189,None,1704139210,0,CANCELLED by 10408
5313281,144,4,1704139189,None,1704139210,0,CANCELLED by 10408
5313282,144,4,1704139189,None,1704139210,0,CANCELLED by 10408
5313283,144,4,1704139189,None,1704139210,0,CANCELLED by 10408
5313284,144,4,1704139189,None,1704139210,0,CANCELLED by 10408
5313285,144,4,1704139189,None,1704139210,0,CANCELLED by 10408
5313286,144,4,1704139189,None,1704139210,0,CANCELLED by 10408
5313271,144,4,1704139189,1704139189,1704139210,21,CANCELLED by 10408
5313272,144,4,1704139189,1704139189,1704139210,21,CANCELLED by 10408
5313273,144,4,1704139189,1704139189,1704139210,21,CANCELLED by 10408
5313274,144,4,1704139189,1704139189,1704139210,21,CANCELLED by 10408
5313275,144,4,1704139189,1704139189,1704139210,21,CANCELLED by 10408
5313287,144,4,1704139190,None,1704139210,0,CANCELLED by 10408
5313288,144,4,1704139190,None,1704139210,0,CANCELLED by 10408
5313289,144,4,1704139190,None,1704139210,0,CANCELLED by 10408
5313290,144,4,1704139190,None,1704139210,0,CANCELLED by 10408
5313291,144,4,1704139190,None,1704139210,0,CANCELLED by 10408
5313292,144,4,1704139190,None,1704139210,0,CANCELLED by 10408
5313293,144,4,1704139190,None,1704139210,0,CANCELLED by 10408
5313294,144,4,1704139190,None,1704139210,0,CANCELLED by 10408
5313295,144,4,1704139190,None,1704139210,0,CANCELLED by 10408
5313296,144,4,1704139190,None,1704139210,0,CANCELLED by 10408
5313297,144,4,1704139190,None,1704139210,0,CANCELLED by 10408
5313298,144,4,1704139190,None,1704139210,0,CANCELLED by 10408
5313299,144,4,1704139190,None,1704139210,0,CANCELLED by 10408
5313300,144,4,1704139190,None,1704139210,0,CANCELLED by 10408
5313301,144,4,1704139190,None,1704139210,0,CANCELLED by 10408
5313302,144,4,1704139190,None,1704139210,0,CANCELLED by 10408
5313303,144,4,1704139190,None,1704139210,0,CANCELLED by 10408
5313304,144,4,1704139190,None,1704139210,0,CANCELLED by 10408
5313305,144,4,1704139190,None,1704139210,0,CANCELLED by 10408
5313306,144,4,1704139190,None,1704139210,0,CANCELLED by 10408
5313307,144,4,1704139190,None,1704139210,0,CANCELLED by 10408
5313308,144,4,1704139190,None,1704139210,0,CANCELLED by 10408
5313309,144,4,1704139190,None,1704139210,0,CANCELLED by 10408
5313310,144,4,1704139190,None,1704139210,0,CANCELLED by 10408
5313311,144,4,1704139191,None,1704139210,0,CANCELLED by 10408
5313312,144,4,1704139191,None,1704139210,0,CANCELLED by 10408
5313313,144,4,1704139191,None,1704139210,0,CANCELLED by 10408
5313314,144,4,1704139191,None,1704139210,0,CANCELLED by 10408
5313315,144,4,1704139191,None,1704139210,0,CANCELLED by 10408
5313316,144,4,1704139191,None,1704139210,0,CANCELLED by 10408
5313317,144,4,1704139191,None,1704139210,0,CANCELLED by 10408
5313318,144,4,1704139191,None,1704139210,0,CANCELLED by 10408
5313319,144,4,1704139191,None,1704139210,0,CANCELLED by 10408
5313320,144,4,1704139191,None,1704139210,0,CANCELLED by 10408
5313321,144,4,1704139191,None,1704139210,0,CANCELLED by 10408
5313322,144,4,1704139191,None,1704139210,0,CANCELLED by 10408
5313323,144,4,1704139191,None,1704139210,0,CANCELLED by 10408
5313324,144,4,1704139191,None,1704139210,0,CANCELLED by 10408
5313325,144,4,1704139191,None,1704139210,0,CANCELLED by 10408
5313326,144,4,1704139191,None,1704139210,0,CANCELLED by 10408
5313327,144,4,1704139191,None,1704139210,0,CANCELLED by 10408
5313328,144,4,1704139191,None,1704139210,0,CANCELLED by 10408
5313329,144,4,1704139191,None,1704139210,0,CANCELLED by 10408
5313330,144,4,1704139191,None,1704139210,0,CANCELLED by 10408
5313331,144,4,1704139191,None,1704139210,0,CANCELLED by 10408
5313332,144,4,1704139191,None,1704139210,0,CANCELLED by 10408
5313333,144,4,1704139191,None,1704139210,0,CANCELLED by 10408
5313334,144,4,1704139191,None,1704139210,0,CANCELLED by 10408
5313335,144,4,1704139191,None,1704139210,0,CANCELLED by 10408
5313336,144,4,1704139191,None,1704139210,0,CANCELLED by 10408
5313337,144,4,1704139191,None,1704139210,0,CANCELLED by 10408
5313338,144,4,1704139191,None,1704139210,0,CANCELLED by 10408
5313339,144,4,1704139191,None,1704139210,0,CANCELLED by 10408
5313340,144,4,1704139191,None,1704139210,0,CANCELLED by 10408
5313341,144,4,1704139192,None,1704139210,0,CANCELLED by 10408
5313342,144,4,1704139192,None,1704139210,0,CANCELLED by 10408
5313343,144,4,1704139192,None,1704139210,0,CANCELLED by 10408
5313344,144,4,1704139192,None,1704139210,0,CANCELLED by 10408
5313345,144,4,1704139192,None,1704139210,0,CANCELLED by 10408
5313346,144,4,1704139192,None,1704139210,0,CANCELLED by 10408
5313347,144,4,1704139192,None,1704139210,0,CANCELLED by 10408
5313348,144,4,1704139192,None,1704139210,0,CANCELLED by 10408
5313349,144,4,1704139192,None,1704139210,0,CANCELLED by 10408
5313350,144,4,1704139192,None,1704139210,0,CANCELLED by 10408
5313351,144,4,1704139192,None,1704139210,0,CANCELLED by 10408
5313352,144,4,1704139192,None,1704139210,0,CANCELLED by 10408
5313353,144,4,1704139192,None,1704139210,0,CANCELLED by 10408
5313354,144,4,1704139192,None,1704139210,0,CANCELLED by 10408
5313355,144,4,1704139192,None,1704139210,0,CANCELLED by 10408
5313356,144,4,1704139192,None,1704139210,0,CANCELLED by 10408
5313357,144,4,1704139192,None,1704139210,0,CANCELLED by 10408
5313358,144,4,1704139192,None,1704139210,0,CANCELLED by 10408
5313359,144,4,1704139192,None,1704139210,0,CANCELLED by 10408
5313360,144,4,1704139192,None,1704139210,0,CANCELLED by 10408
5313361,144,4,1704139192,None,1704139210,0,CANCELLED by 10408
5313362,144,4,1704139192,None,1704139210,0,CANCELLED by 10408
5313363,144,4,1704139192,None,1704139210,0,CANCELLED by 10408
5313364,144,4,1704139192,None,1704139210,0,CANCELLED by 10408
5313365,144,4,1704139192,None,1704139210,0,CANCELLED by 10408
5313366,144,4,1704139192,None,1704139210,0,CANCELLED by 10408
5313367,144,4,1704139192,None,1704139210,0,CANCELLED by 10408
5313368,144,4,1704139192,None,1704139210,0,CANCELLED by 10408
5313369,144,4,1704139192,None,1704139210,0,CANCELLED by 10408
5313370,144,4,1704139192,None,1704139210,0,CANCELLED by 10408
5313371,144,4,1704139192,None,1704139210,0,CANCELLED by 10408
5313372,144,4,1704139192,None,1704139210,0,CANCELLED by 10408
5313373,144,4,1704139192,None,1704139210,0,CANCELLED by 10408
5313374,144,4,1704139192,None,1704139210,0,CANCELLED by 10408
5313375,144,4,1704139192,None,1704139210,0,CANCELLED by 10408
5313376,144,4,1704139192,None,1704139210,0,CANCELLED by 10408
5313377,144,4,1704139192,None,1704139210,0,CANCELLED by 10408
5313378,144,4,1704139193,None,1704139210,0,CANCELLED by 10408
5313379,144,4,1704139193,None,1704139210,0,CANCELLED by 10408
5313380,144,4,1704139193,None,1704139210,0,CANCELLED by 10408
5313381,144,4,1704139193,None,1704139210,0,CANCELLED by 10408
5313382,144,4,1704139193,None,1704139210,0,CANCELLED by 10408
5313383,144,4,1704139193,None,1704139210,0,CANCELLED by 10408
5313384,144,4,1704139193,None,1704139210,0,CANCELLED by 10408
5313385,144,4,1704139193,None,1704139210,0,CANCELLED by 10408
5313386,144,4,1704139193,None,1704139210,0,CANCELLED by 10408
5313387,144,4,1704139193,None,1704139210,0,CANCELLED by 10408
5313388,144,4,1704139193,None,1704139210,0,CANCELLED by 10408
5313389,144,4,1704139193,None,1704139210,0,CANCELLED by 10408
5313390,144,4,1704139193,None,1704139210,0,CANCELLED by 10408
5313391,144,4,1704139193,None,1704139210,0,CANCELLED by 10408
5313392,144,4,1704139194,None,1704139210,0,CANCELLED by 10408
5313393,144,4,1704139194,None,1704139210,0,CANCELLED by 10408
5313394,144,4,1704139194,None,1704139210,0,CANCELLED by 10408
5313395,144,4,1704139194,None,1704139210,0,CANCELLED by 10408
5313396,144,4,1704139194,None,1704139210,0,CANCELLED by 10408
5313397,144,4,1704139194,None,1704139210,0,CANCELLED by 10408
5313398,144,4,1704139194,None,1704139210,0,CANCELLED by 10408
5313399,144,4,1704139194,None,1704139210,0,CANCELLED by 10408
5313400,144,4,1704139194,None,1704139210,0,CANCELLED by 10408
5313401,144,4,1704139194,None,1704139210,0,CANCELLED by 10408
5313402,144,4,1704139194,None,1704139210,0,CANCELLED by 10408
5313403,144,4,1704139194,None,1704139210,0,CANCELLED by 10408
5313404,144,4,1704139194,None,1704139210,0,CANCELLED by 10408
5313405,144,4,1704139194,None,1704139210,0,CANCELLED by 10408
5313406,144,4,1704139194,None,1704139210,0,CANCELLED by 10408
5313407,144,4,1704139194,None,1704139210,0,CANCELLED by 10408
5313408,144,4,1704139194,None,1704139210,0,CANCELLED by 10408
5313409,144,4,1704139195,None,1704139210,0,CANCELLED by 10408
5313410,144,4,1704139195,None,1704139210,0,CANCELLED by 10408
5313411,144,4,1704139195,None,1704139210,0,CANCELLED by 10408
5313412,144,4,1704139195,None,1704139210,0,CANCELLED by 10408
5313413,144,4,1704139195,None,1704139210,0,CANCELLED by 10408
5313414,144,4,1704139195,None,1704139210,0,CANCELLED by 10408
5313415,144,4,1704139195,None,1704139210,0,CANCELLED by 10408
5313416,144,4,1704139195,None,1704139210,0,CANCELLED by 10408
5313417,36,1,1704140950,1704140950,1704140956,6,FAILED
5313419,36,1,1704141155,1704141155,1704141298,143,TIMEOUT
5313420,36,1,1704141369,1704141370,1704141531,161,CANCELLED by 46947
5313421,36,1,1704142662,1704142663,1704154820,12157,COMPLETED
5313422,144,4,1704143849,1704143849,1704182280,38431,COMPLETED
5313423,144,4,1704143849,1704143849,1704177485,33636,COMPLETED
5313424,144,4,1704143849,1704143849,1704179988,36139,COMPLETED
5313425,144,4,1704143849,1704143849,1704179772,35923,COMPLETED
5313426,144,4,1704143849,1704143853,1704173948,30095,COMPLETED
5313427,144,4,1704143849,1704143853,1704180643,36790,COMPLETED
5313428,144,4,1704143850,1704143853,1704182088,38235,COMPLETED
5313429,144,4,1704143850,1704143853,1704188257,44404,COMPLETED
5313430,144,4,1704143850,1704143853,1704169028,25175,COMPLETED
5313431,144,4,1704143850,1704143853,1704182368,38515,COMPLETED
5313432,144,4,1704143850,1704143853,1704174163,30310,COMPLETED
5313433,144,4,1704143850,1704143853,1704178101,34248,COMPLETED
5313434,144,4,1704143850,1704143853,1704175205,31352,COMPLETED
5313435,144,4,1704143850,1704143853,1704170927,27074,COMPLETED
5313436,144,4,1704143850,1704143853,1704175464,31611,COMPLETED
5313437,144,4,1704143850,1704143853,1704174591,30738,COMPLETED
5313438,144,4,1704143850,1704143853,1704184438,40585,COMPLETED
5313439,144,4,1704143851,1704143853,1704176160,32307,COMPLETED
5313440,144,4,1704143851,1704143853,1704175976,32123,COMPLETED
5313441,144,4,1704143851,1704143853,1704174618,30765,COMPLETED
5313442,144,4,1704143851,1704143853,1704184594,40741,COMPLETED
5313443,144,4,1704143851,1704143853,1704172784,28931,COMPLETED
5313444,144,4,1704143851,1704169029,1704209452,40423,COMPLETED
5313445,144,4,1704143851,1704170928,1704203555,32627,COMPLETED
5313446,144,4,1704143851,1704172785,1704203919,31134,COMPLETED
5313447,144,4,1704143851,1704173950,1704212066,38116,COMPLETED
5313448,144,4,1704143851,1704174164,1704201090,26926,COMPLETED
5313449,144,4,1704143851,1704174593,1704212805,38212,COMPLETED
5313450,144,4,1704143851,1704174619,1704209131,34512,COMPLETED
5313451,144,4,1704143851,1704175206,1704207461,32255,COMPLETED
5313452,144,4,1704143851,1704175465,1704213238,37773,COMPLETED
5313453,144,4,1704143851,1704175977,1704207625,31648,COMPLETED
5313454,144,4,1704143851,1704176162,1704216502,40340,COMPLETED
5313455,144,4,1704143851,1704177487,1704217246,39759,COMPLETED
5313456,144,4,1704143851,1704178103,1704212705,34602,COMPLETED
5313457,144,4,1704143851,1704179773,1704219773,40000,COMPLETED
5313458,144,4,1704143851,1704179989,1704215686,35697,COMPLETED
5313459,144,4,1704143851,1704180644,1704212648,32004,COMPLETED
5313460,144,4,1704143851,1704182089,1704213060,30971,COMPLETED
5313461,144,4,1704143851,1704182282,1704210154,27872,COMPLETED
5313462,144,4,1704143852,1704182369,1704215123,32754,COMPLETED
5313463,144,4,1704143852,1704184439,1704215194,30755,COMPLETED
5313464,144,4,1704143852,1704184596,1704211230,26634,COMPLETED
5313465,144,4,1704143852,1704188258,1704232341,44083,COMPLETED
5313466,144,4,1704143852,1704201092,1704236098,35006,COMPLETED
5313467,144,4,1704143852,1704203556,1704234086,30530,COMPLETED
5313468,144,4,1704143852,1704203920,1704239959,36039,COMPLETED
5313469,144,4,1704143852,1704207462,1704236540,29078,COMPLETED
5313470,144,4,1704143852,1704207626,1704244207,36581,COMPLETED
5313471,144,4,1704143852,1704209132,1704243186,34054,COMPLETED
5313472,144,4,1704143852,1704209453,1704235046,25593,COMPLETED
5313473,144,4,1704143852,1704210155,1704242283,32128,COMPLETED
5313474,144,4,1704143852,1704211232,1704242555,31323,COMPLETED
5313475,144,4,1704143852,1704212067,1704243889,31822,COMPLETED
5313476,144,4,1704143852,1704212649,1704247077,34428,COMPLETED
5313477,144,4,1704143852,1704212706,1704254333,41627,COMPLETED
5313478,144,4,1704143852,1704212806,1704252536,39730,COMPLETED
5313479,144,4,1704143852,1704213061,1704235731,22670,COMPLETED
5313480,144,4,1704143852,1704213239,1704244367,31128,COMPLETED
5313481,144,4,1704143852,1704215124,1704245886,30762,COMPLETED
5313482,144,4,1704143852,1704215195,1704248115,32920,COMPLETED
5313483,144,4,1704143852,1704215687,1704253845,38158,COMPLETED
5313484,144,4,1704143852,1704216503,1704245883,29380,COMPLETED
5313485,144,4,1704143852,1704217247,1704257101,39854,COMPLETED
5313486,144,4,1704143852,1704219774,1704252951,33177,COMPLETED
5313487,144,4,1704143852,1704234088,1704268306,34218,COMPLETED
5313488,144,4,1704143852,1704234707,1704264439,29732,COMPLETED
5313489,144,4,1704143852,1704235047,1704273210,38163,COMPLETED
5313490,144,4,1704143852,1704235732,1704265100,29368,COMPLETED
5313491,144,4,1704143852,1704236099,1704272449,36350,COMPLETED
5313492,144,4,1704143853,1704236542,1704264222,27680,COMPLETED
5313493,144,4,1704143853,1704239959,1704274656,34697,COMPLETED
5313494,144,4,1704143853,1704242284,1704277889,35605,COMPLETED
5313495,144,4,1704143853,1704242556,1704277159,34603,COMPLETED
5313496,144,4,1704143853,1704243188,1704284858,41670,COMPLETED
5313497,144,4,1704143853,1704243890,1704283732,39842,COMPLETED
5313498,144,4,1704143853,1704244209,1704277383,33174,COMPLETED
5313499,144,4,1704143853,1704244369,1704280312,35943,COMPLETED
5313500,144,4,1704143853,1704245884,1704275792,29908,COMPLETED
5313501,144,4,1704143853,1704245888,1704282828,36940,COMPLETED
5313502,144,4,1704143853,1704247078,1704284604,37526,COMPLETED
5313503,144,4,1704143853,1704248116,1704280188,32072,COMPLETED
5313504,144,4,1704143853,1704252537,1704295812,43275,COMPLETED
5313505,144,4,1704143853,1704252952,1704289815,36863,COMPLETED
5313506,144,4,1704143853,1704253846,1704288634,34788,COMPLETED
5313507,144,4,1704143853,1704254334,1704296875,42541,COMPLETED
5313508,144,4,1704143853,1704257103,1704294097,36994,COMPLETED
5313509,144,4,1704143854,1704264224,1704295441,31217,COMPLETED
5313510,144,4,1704143854,1704264440,1704301811,37371,COMPLETED
5313511,144,4,1704143854,1704265100,1704302206,37106,COMPLETED
5313512,144,4,1704143854,1704268308,1704303530,35222,COMPLETED
5313513,144,4,1704143854,1704272450,1704310813,38363,COMPLETED
5313514,144,4,1704143854,1704273211,1704310528,37317,COMPLETED
5313515,144,4,1704143854,1704274656,1704303311,28655,COMPLETED
5313516,144,4,1704143854,1704275793,1704309663,33870,COMPLETED
5313517,144,4,1704143854,1704277161,1704323066,45905,COMPLETED
5313518,144,4,1704143854,1704277385,1704304793,27408,COMPLETED
5313519,144,4,1704143854,1704277890,1704314299,36409,COMPLETED
5313520,144,4,1704143854,1704280189,1704313590,33401,COMPLETED
5313521,144,4,1704143854,1704280313,1704310983,30670,COMPLETED
5313522,144,4,1704143854,1704282830,1704319200,36370,COMPLETED
5313523,144,4,1704143854,1704283733,1704313237,29504,COMPLETED
5313524,144,4,1704143854,1704284605,1704318154,33549,COMPLETED
5313525,144,4,1704143854,1704284859,1704315197,30338,COMPLETED
5313526,144,4,1704143854,1704289356,1704318282,28926,COMPLETED
5313527,144,4,1704143854,1704290079,1704318922,28843,COMPLETED
5313528,144,4,1704143854,1704294097,1704323965,29868,COMPLETED
5313529,144,4,1704143854,1704295442,1704331299,35857,COMPLETED
5313530,144,4,1704143854,1704295814,1704329048,33234,COMPLETED
5313531,144,4,1704143854,1704296876,1704321886,25010,COMPLETED
5313532,144,4,1704143854,1704301812,1704335079,33267,COMPLETED
5313533,144,4,1704143855,1704302208,1704329814,27606,COMPLETED
5313534,144,4,1704143855,1704303312,1704332845,29533,COMPLETED
5313535,144,4,1704143855,1704303532,1704333729,30197,COMPLETED
5313536,144,4,1704143855,1704304795,1704336263,31468,COMPLETED
5313537,144,4,1704143855,1704309665,1704345262,35597,COMPLETED
5313538,144,4,1704143855,1704310529,1704342642,32113,COMPLETED
5313539,144,4,1704143855,1704310815,1704344248,33433,COMPLETED
5313540,144,4,1704143855,1704310984,1704342991,32007,COMPLETED
5313541,144,4,1704143855,1704313239,1704348495,35256,COMPLETED
5313542,144,4,1704143855,1704313592,1704349431,35839,COMPLETED
5313543,144,4,1704143855,1704314301,1704344628,30327,COMPLETED
5313544,144,4,1704143855,1704315199,1704347364,32165,COMPLETED
5313545,144,4,1704143855,1704318155,1704348803,30648,COMPLETED
5313546,144,4,1704143855,1704318283,1704354210,35927,COMPLETED
5313547,144,4,1704143855,1704318923,1704357572,38649,COMPLETED
5313548,144,4,1704143855,1704319201,1704351033,31832,COMPLETED
5313549,144,4,1704143855,1704321887,1704354521,32634,COMPLETED
5313550,144,4,1704143855,1704323067,1704356453,33386,COMPLETED
5313551,144,4,1704143855,1704323966,1704362501,38535,COMPLETED
5313552,144,4,1704143855,1704329050,1704365235,36185,COMPLETED
5313553,144,4,1704143855,1704329815,1704360791,30976,COMPLETED
5313554,144,4,1704143855,1704331300,1704374262,42962,COMPLETED
5313555,144,4,1704143855,1704332847,1704373181,40334,COMPLETED
5313556,144,4,1704143855,1704333730,1704365187,31457,COMPLETED
5313557,144,4,1704143855,1704335080,1704366644,31564,COMPLETED
5313558,144,4,1704143855,1704336264,1704368181,31917,COMPLETED
5313559,144,4,1704143855,1704342644,1704378866,36222,COMPLETED
5313560,144,4,1704143855,1704342993,1704383641,40648,COMPLETED
5313561,144,4,1704143855,1704344250,1704384018,39768,COMPLETED
5313562,144,4,1704143855,1704344630,1704373521,28891,COMPLETED
5313563,144,4,1704143855,1704345263,1704383758,38495,COMPLETED
5313564,144,4,1704143856,1704347366,1704384971,37605,COMPLETED
5313565,144,4,1704143856,1704348496,1704388302,39806,COMPLETED
5313566,144,4,1704143856,1704348804,1704390038,41234,COMPLETED
5313567,144,4,1704143856,1704349433,1704370498,21065,COMPLETED
5313568,144,4,1704143856,1704351034,1704386470,35436,COMPLETED
5313569,144,4,1704143856,1704354211,1704386031,31820,COMPLETED
5313570,144,4,1704143856,1704354522,1704383838,29316,COMPLETED
5313571,144,4,1704143856,1704356455,1704391887,35432,COMPLETED
5313572,144,4,1704143856,1704357573,1704391796,34223,COMPLETED
5313573,144,4,1704143856,1704360792,1704398082,37290,COMPLETED
5313574,144,4,1704143856,1704362503,1704396370,33867,COMPLETED
5313575,144,4,1704143856,1704365188,1704405117,39929,COMPLETED
5313576,144,4,1704143856,1704365237,1704397265,32028,COMPLETED
5313577,144,4,1704143856,1704367758,1704393704,25946,COMPLETED
5313578,144,4,1704143856,1704368183,1704400385,32202,COMPLETED
5313579,144,4,1704143857,1704370970,1704405584,34614,COMPLETED
5313580,144,4,1704143857,1704373183,1704405441,32258,COMPLETED
5313581,144,4,1704143857,1704373523,1704407929,34406,COMPLETED
5313582,144,4,1704143857,1704374264,1704407566,33302,COMPLETED
5313583,144,4,1704143857,1704378868,1704418022,39154,COMPLETED
5313584,144,4,1704143857,1704383643,1704422200,38557,COMPLETED
5313585,144,4,1704143857,1704383760,1704430183,46423,COMPLETED
5313586,144,4,1704143959,1704143964,1704193679,49715,COMPLETED
5313587,144,4,1704143959,1704143964,1704190550,46586,COMPLETED
5313588,144,4,1704143960,1704143964,1704184202,40238,COMPLETED
5313589,144,4,1704143960,1704143964,1704188761,44797,COMPLETED
5313590,144,4,1704143960,1704143964,1704155003,11039,FAILED
5313591,144,4,1704143960,1704155025,1704186384,31359,COMPLETED
5313592,144,4,1704143960,1704159714,1704221311,61597,COMPLETED
5313593,144,4,1704143960,1704159714,1704204946,45232,COMPLETED
5313594,144,4,1704143960,1704159714,1704210079,50365,COMPLETED
5313595,144,4,1704143960,1704159714,1704196757,37043,COMPLETED
5313596,144,4,1704143960,1704184203,1704238178,53975,COMPLETED
5313597,144,4,1704143960,1704186385,1704232388,46003,COMPLETED
5313598,144,4,1704143960,1704188762,1704234706,45944,COMPLETED
5313599,144,4,1704143960,1704190551,1704246762,56211,COMPLETED
5313600,144,4,1704143960,1704199397,1704241385,41988,COMPLETED
5313601,144,4,1704143960,1704203642,1704247973,44331,COMPLETED
5313602,144,4,1704143960,1704204947,1704242573,37626,COMPLETED
5313603,144,4,1704143960,1704210079,1704255958,45879,COMPLETED
5313604,144,4,1704143960,1704221312,1704269957,48645,COMPLETED
5313605,144,4,1704143960,1704235151,1704281838,46687,COMPLETED
5313606,144,4,1704143960,1704235151,1704283065,47914,COMPLETED
5313607,144,4,1704143960,1704238179,1704293750,55571,COMPLETED
5313608,144,4,1704143960,1704241386,1704292197,50811,COMPLETED
5313609,144,4,1704143960,1704242574,1704290078,47504,COMPLETED
5313610,144,4,1704143960,1704246763,1704297446,50683,COMPLETED
5313611,144,4,1704143960,1704247975,1704296461,48486,COMPLETED
5313612,144,4,1704143961,1704255959,1704305312,49353,COMPLETED
5313613,144,4,1704143961,1704269958,1704310582,40624,COMPLETED
5313614,144,4,1704143961,1704281839,1704323610,41771,COMPLETED
5313615,144,4,1704143961,1704290552,1704343655,53103,COMPLETED
5313616,144,4,1704143961,1704292137,1704339338,47201,COMPLETED
5313617,144,4,1704143961,1704292199,1704345344,53145,COMPLETED
5313618,144,4,1704143961,1704293751,1704337696,43945,COMPLETED
5313619,144,4,1704143961,1704296463,1704361229,64766,COMPLETED
5313620,144,4,1704143961,1704321712,1704364721,43009,COMPLETED
5313621,144,4,1704143961,1704323611,1704373992,50381,COMPLETED
5313622,144,4,1704143961,1704323632,1704361852,38220,COMPLETED
5313623,144,4,1704143961,1704330773,1704378541,47768,COMPLETED
5313624,144,4,1704143961,1704337698,1704390543,52845,COMPLETED
5313625,144,4,1704143961,1704339339,1704384871,45532,COMPLETED
5313626,144,4,1704143961,1704343657,1704384351,40694,COMPLETED
5313627,144,4,1704143961,1704345346,1704391272,45926,COMPLETED
5313628,144,4,1704143961,1704361231,1704408882,47651,COMPLETED
5313629,144,4,1704143961,1704361854,1704408476,46622,COMPLETED
5313630,144,4,1704143961,1704402527,1704452045,49518,COMPLETED
5313631,144,4,1704143961,1704404490,1704460716,56226,COMPLETED
5313632,144,4,1704143961,1704404998,1704452724,47726,COMPLETED
5313633,144,4,1704143962,1704405007,1704450557,45550,COMPLETED
5313634,144,4,1704143962,1704405119,1704447321,42202,COMPLETED
5313635,144,4,1704143962,1704405443,1704450894,45451,COMPLETED
5313636,144,4,1704143962,1704405585,1704457496,51911,COMPLETED
5313637,36,1,1704145235,1704145236,1704145245,9,COMPLETED
5313638,36,1,1704145340,1704145343,1704145387,44,COMPLETED
5313639,36,1,1704145461,1704145463,1704145495,32,COMPLETED
5313640,36,1,1704147640,1704147641,1704147662,21,COMPLETED
5313641,36,1,1704147713,1704147714,1704147729,15,COMPLETED
5313642,36,1,1704147858,1704147858,1704147872,14,COMPLETED
5313643,36,1,1704147930,1704147931,1704147944,13,COMPLETED
5313644,36,1,1704148020,1704148021,1704148032,11,COMPLETED
5313645,36,1,1704148109,1704148110,1704148121,11,COMPLETED
5313646,36,1,1704148182,1704148182,1704148192,10,COMPLETED
5313647,36,1,1704148252,1704148252,1704148261,9,COMPLETED
5313648,36,1,1704148292,1704148293,1704148302,9,COMPLETED
5313649,72,2,1704148370,1704148370,1704148382,12,COMPLETED
5313650,144,4,1704148459,1704148459,1704148473,14,COMPLETED
5313651,1,1,1704148479,1704148480,1704185481,37001,COMPLETED
5313652,288,8,1704148535,1704148536,1704148555,19,COMPLETED
5313653,576,16,1704148620,1704148620,1704148684,64,TIMEOUT
5313654,576,16,1704148725,1704148725,1704148755,30,COMPLETED
5313655,1152,32,1704148821,1704148823,1704148835,12,COMPLETED
5313656,2304,64,1704148918,1704148955,1704148997,42,COMPLETED
5313657,4608,128,1704149243,None,1704161047,0,CANCELLED by 46082
5313659,108,3,1704150813,1704150816,1704323625,172809,TIMEOUT
5313660,108,3,1704150894,1704150906,1704321109,170203,CANCELLED by 46077
5313661,22,1,1704150967,1704150996,1704323805,172809,TIMEOUT
5313662,22,1,1704151146,1704151176,1704214273,63097,CANCELLED by 46077
5313665,4,1,1704152148,1704152169,1704152171,2,FAILED
5313666,24,1,1704152347,1704152349,1704321708,169359,CANCELLED by 46077
5313667,24,1,1704152359,1704152379,1704325185,172806,TIMEOUT
5313668,144,4,1704160152,1704160165,1704160173,8,COMPLETED
5313669,144,4,1704160261,1704160285,1704160296,11,COMPLETED
5313670,72,2,1704160402,1704160406,1704160413,7,COMPLETED
5313671,36,1,1704160518,1704160526,1704160530,4,COMPLETED
5313672,36,1,1704160629,1704160646,1704160650,4,COMPLETED
5313673,36,1,1704160711,1704160736,1704160742,6,COMPLETED
5313674,36,1,1704160825,1704160826,1704160831,5,COMPLETED
5313675,36,1,1704160868,1704160886,1704160891,5,COMPLETED
5313676,36,1,1704160958,1704160977,1704160981,4,COMPLETED
5313677,36,1,1704161677,1704161677,1704161680,3,COMPLETED
5313678,36,1,1704161706,1704161707,1704161717,10,COMPLETED
5313679,72,2,1704161790,1704161791,1704161803,12,COMPLETED
5313680,144,4,1704161875,1704161876,1704161891,15,COMPLETED
5313681,288,8,1704161948,1704161948,1704161968,20,COMPLETED
5313682,576,16,1704162029,1704162030,1704162064,34,COMPLETED
5313683,1152,32,1704162105,1704162106,1704162126,20,COMPLETED
5313684,432,12,1704162228,1704162229,1704162256,27,COMPLETED
5313685,24,1,1704162331,1704162332,1704162495,163,CANCELLED by 46530
5313686,360,10,1704162352,1704162353,1704162376,23,COMPLETED
5313687,324,9,1704162449,1704162449,1704162471,22,COMPLETED
5313688,24,1,1704162509,1704162509,1704194941,32432,COMPLETED
5313689,216,6,1704162544,1704162545,1704162562,17,COMPLETED
5313690,180,5,1704162634,1704162634,1704162650,16,COMPLETED
5313691,252,7,1704162743,1704162744,1704162763,19,COMPLETED
5313692,216,6,1704162815,1704162816,1704162834,18,COMPLETED
5313693,72,2,1704165671,1704165672,1704168606,2934,FAILED
5313694,72,2,1704177867,1704177867,1704177912,45,FAILED
5313695,72,2,1704178728,1704178728,1704178739,11,FAILED
5313696,72,2,1704178859,1704178860,1704178871,11,FAILED
5313697,72,2,1704179177,1704179178,1704179215,37,FAILED
5313698,72,2,1704179370,1704179370,1704179381,11,FAILED
5313699,72,2,1704179545,1704179545,1704182563,3018,FAILED
5313700,72,2,1704182994,1704182995,1704185804,2809,FAILED
5313701,144,4,1704185358,1704185359,1704208579,23220,CANCELLED by 45900
5313702_1,36,1,1704185950,1704185950,1704274731,88781,COMPLETED
5313702_2,36,1,1704185950,1704185950,1704250003,64053,COMPLETED
5313702_3,36,1,1704185950,1704185950,1704250504,64554,COMPLETED
5313705_1,36,1,1704186012,1704186012,1704221196,35184,COMPLETED
5313705_2,36,1,1704186012,1704186012,1704233939,47927,COMPLETED
5313705_3,36,1,1704186012,1704186012,1704284382,98370,COMPLETED
5313708_1,36,1,1704186112,1704186114,1704257082,70968,COMPLETED
5313708_2,36,1,1704186112,1704186114,1704271829,85715,COMPLETED
5313708_3,36,1,1704186112,1704186115,1704273739,87624,COMPLETED
5313711_1,36,1,1704186292,1704186293,1704253829,67536,COMPLETED
5313711_2,36,1,1704186292,1704186293,1704279548,93255,COMPLETED
5313711_3,36,1,1704186292,1704186293,1704240163,53870,COMPLETED
5313714_1,36,1,1704188787,1704188787,1704361607,172820,TIMEOUT
5313714_2,36,1,1704188787,1704188787,1704361607,172820,TIMEOUT
5313714_3,36,1,1704188787,1704188787,1704361607,172820,TIMEOUT
5313717_1,36,1,1704188937,1704188937,1704188959,22,CANCELLED by 14418
5313717_2,36,1,1704188937,1704188937,1704188959,22,CANCELLED by 14418
5313717_3,36,1,1704188937,1704188937,1704188959,22,CANCELLED by 14418
5313720_1,36,1,1704189007,1704189008,1704189021,13,COMPLETED
5313720_2,36,1,1704189007,1704189008,1704189021,13,COMPLETED
5313720_3,36,1,1704189007,1704189008,1704189021,13,COMPLETED
5313723_1,36,1,1704189104,1704189105,1704361907,172802,TIMEOUT
5313723_2,36,1,1704189104,1704189105,1704361907,172802,TIMEOUT
5313723_3,36,1,1704189104,1704189105,1704361907,172802,TIMEOUT
5313726_1,36,1,1704189185,1704189186,1704361997,172811,TIMEOUT
5313726_2,36,1,1704189185,1704189186,1704361997,172811,TIMEOUT
5313726_3,36,1,1704189185,1704189186,1704361997,172811,TIMEOUT
5313729_1,36,1,1704189238,1704189239,1704362057,172818,TIMEOUT
5313729_2,36,1,1704189238,1704189239,1704362057,172818,TIMEOUT
5313729_3,36,1,1704189238,1704189239,1704362057,172818,TIMEOUT
5313732_1,36,1,1704189283,1704189283,1704362087,172804,TIMEOUT
5313732_2,36,1,1704189283,1704189283,1704362087,172804,TIMEOUT
5313732_3,36,1,1704189283,1704189284,1704362087,172803,TIMEOUT
5313735_1,36,1,1704189379,1704189383,1704362207,172824,TIMEOUT
5313735_2,36,1,1704189379,1704189383,1704362207,172824,TIMEOUT
5313735_3,36,1,1704189379,1704189383,1704362207,172824,TIMEOUT
5313738_1,36,1,1704189453,1704189453,1704333310,143857,COMPLETED
5313738_2,36,1,1704189453,1704189453,1704362267,172814,TIMEOUT
5313738_3,36,1,1704189453,1704189454,1704362267,172813,TIMEOUT
5313741_1,36,1,1704189517,1704189517,1704362327,172810,TIMEOUT
5313741_2,36,1,1704189517,1704189517,1704362327,172810,TIMEOUT
5313741_3,36,1,1704189517,1704189517,1704362327,172810,TIMEOUT
5313744_1,36,1,1704189661,1704221197,1704394024,172827,TIMEOUT
5313744_2,36,1,1704189661,1704235151,1704407976,172825,TIMEOUT
5313744_3,36,1,1704189661,1704240164,1704412986,172822,TIMEOUT
5313745_1,36,1,1704189702,1704250003,1704422827,172824,TIMEOUT
5313745_2,36,1,1704189702,1704250505,1704423307,172802,TIMEOUT
5313745_3,36,1,1704189702,1704253830,1704426637,172807,TIMEOUT
5313746_1,36,1,1704189763,1704257084,1704429907,172823,TIMEOUT
5313746_2,36,1,1704189763,1704271829,1704444638,172809,TIMEOUT
5313746_3,36,1,1704189763,1704273740,1704446558,172818,TIMEOUT
5313747_1,36,1,1704189806,1704274732,1704447548,172816,TIMEOUT
5313747_2,36,1,1704189806,1704279550,1704452378,172828,TIMEOUT
5313747_3,36,1,1704189806,1704292137,1704464948,172811,TIMEOUT
5313748_1,36,1,1704189854,1704333311,1704506140,172829,TIMEOUT
5313748_2,36,1,1704189854,1704361611,1704534438,172827,TIMEOUT
5313748_3,36,1,1704189854,1704361611,1704534438,172827,TIMEOUT
5313749,360,10,1704191758,1704191759,1704202968,11209,FAILED
5313750,360,10,1704191843,1704191843,1704202850,11007,FAILED
5313752,180,5,1704192244,1704192244,1704193804,1560,FAILED
5313753,36,1,1704192306,1704192306,1704192308,2,FAILED
5313754,360,10,1704192340,1704192341,1704192343,2,FAILED
5313755,72,2,1704192572,1704192572,1704195523,2951,FAILED
5313756,36,1,1704192679,1704192683,1704196294,3611,TIMEOUT
5313757,180,5,1704193116,1704193116,1704193123,7,FAILED
5313758,360,10,1704193143,1704193143,1704193150,7,FAILED
5313760,360,10,1704193294,1704193295,1704203615,10320,FAILED
5313762,180,5,1704193325,1704193325,1704260665,67340,FAILED
5313765,360,10,1704193549,1704193943,1704261438,67495,FAILED
5313766,360,10,1704193663,1704202667,1704268019,65352,FAILED
5313768,360,10,1704193701,1704202851,1704260663,57812,FAILED
5313769,360,10,1704193769,1704202969,1704266926,63957,FAILED
5313771,360,10,1704193889,1704204462,1704239914,35452,FAILED
5313772,180,5,1704193919,1704203191,1704223882,20691,FAILED
5313780,72,2,1704196255,1704196256,1704199372,3116,FAILED
5313783,36,1,1704199622,1704199623,1704242826,43203,TIMEOUT
5313787,36,1,1704201539,1704201539,1704201548,9,COMPLETED
5313788,216,6,1704203086,1704203616,1705413236,1209620,TIMEOUT
5313789,36,1,1704203345,1704203522,1704203527,5,FAILED
5313790,360,10,1704203474,1704204463,1704261131,56668,FAILED
5313791,360,10,1704203500,1704204463,1704253439,48976,FAILED
5313792,1,1,1704203929,1704203929,1704203932,3,FAILED
5313796,1,1,1704204125,1704204126,1704204129,3,COMPLETED
5313798,1,1,1704204126,1704204151,1704204154,3,COMPLETED
5313802,1,1,1704205087,1704205087,1704205092,5,COMPLETED
5313804,1,1,1704205087,1704205103,1704205106,3,COMPLETED
5313807,36,1,1704210211,1704210211,1704210274,63,TIMEOUT
5313808,36,1,1704210249,1704210249,1704210477,228,CANCELLED by 14418
5313809,36,1,1704210811,1704210812,1704210913,101,COMPLETED
5313810,36,1,1704211000,1704211001,1704211883,882,COMPLETED
5313811,36,1,1704211807,1704211807,1704211880,73,CANCELLED by 14418
5313812,72,2,1704211893,1704211894,1704211960,66,CANCELLED by 45889
5313813,72,2,1704212021,1704212021,1704212345,324,TIMEOUT
5313814,36,1,1704212040,1704212040,1704234000,21960,COMPLETED
5313815,36,1,1704212208,1704212209,1704251925,39716,COMPLETED
5313816,72,2,1704212814,1704212815,1704212885,70,COMPLETED
5313817,72,2,1704213074,1704213074,1704213335,261,TIMEOUT
5313818,72,2,1704213268,1704213268,1704273358,60090,CANCELLED by 45900
5313819,72,2,1704213394,1704213395,1704213525,130,COMPLETED
5313820,36,1,1704214039,1704214039,1704214047,8,COMPLETED
5313821,72,2,1704214794,1704214794,1704214810,16,FAILED
5313823,72,2,1704215222,1704215222,1704215238,16,FAILED
5313824,108,3,1704215279,1704215279,1704388083,172804,TIMEOUT
5313825,72,2,1704216245,1704216245,1704216274,29,CANCELLED by 46947
5313826,72,2,1704216326,1704216326,1704226427,10101,COMPLETED
5313827,36,1,1704216376,1704216377,1704219386,3009,COMPLETED
5313829,144,4,1704218617,1704218617,1704391444,172827,TIMEOUT
5313835,4,1,1704220638,1704220638,1704228362,7724,FAILED
5313836,216,6,1704220819,1704220819,1704220821,2,COMPLETED
5313837,756,21,1704220879,1704424956,1704568784,143828,COMPLETED
5313840,36,1,1704222427,1704222427,1704222743,316,COMPLETED
5313841,36,1,1704223890,1704223891,1704224259,368,COMPLETED
5313842,72,2,1704223984,1704223985,1704223996,11,FAILED
5313843,72,2,1704224254,1704224254,1704224265,11,FAILED
5313844,36,1,1704224370,1704224371,1704224745,374,COMPLETED
5313845,36,1,1704224754,1704224754,1704225118,364,COMPLETED
5313846,216,6,1704224754,1704224754,1704224852,98,FAILED
5313847,36,1,1704225255,1704225255,1704225280,25,FAILED
5313848,216,6,1704226110,1704226111,1704226207,96,FAILED
5313849,144,4,1704226960,1704226960,1704226974,14,FAILED
5313850,144,4,1704227047,1704227048,1704227072,24,FAILED
5313851,144,4,1704227564,1704227565,1704227710,145,CANCELLED by 46947
5313852,432,12,1704228560,1704228562,1704333129,104567,COMPLETED
5313854,36,1,1704229128,1704229129,1704229421,292,COMPLETED
5313856,432,12,1704230656,1704233940,1704235146,1206,TIMEOUT
5313876,4,1,1704239697,1704239697,1704247210,7513,FAILED
5313883,72,2,1704270680,1704270680,1704270805,125,TIMEOUT
5313885,1,1,1704273128,None,1704273682,0,CANCELLED by 10099
5313886,144,4,1704273410,1704273411,1704284664,11253,CANCELLED by 45900
5313887,1,1,1704273692,None,1704273711,0,CANCELLED by 10099
5313888,36,1,1704273727,1704273728,1704276858,3130,COMPLETED
5313890_1,36,1,1704274807,1704274808,1704389121,114313,COMPLETED
5313890_2,36,1,1704274807,1704274808,1704380953,106145,COMPLETED
5313890_3,36,1,1704274807,1704274808,1704336786,61978,COMPLETED
5313893_1,36,1,1704274926,1704274927,1704363089,88162,COMPLETED
5313893_2,36,1,1704274926,1704274927,1704388871,113944,COMPLETED
5313893_3,36,1,1704274926,1704274927,1704399758,124831,COMPLETED
5313896,1,1,1704274931,None,1704274941,0,CANCELLED by 10099
5313897,1,1,1704274945,None,1704277857,0,CANCELLED by 10099
5313898,36,1,1704275111,1704275111,1704275514,403,FAILED
5313899,72,2,1704275381,1704275382,1704278424,3042,CANCELLED by 45900
5313900,4,1,1704275564,1704275564,1704275644,80,CANCELLED by 45363
5313901,360,10,1704276460,1704276461,1704276468,7,FAILED
5313902,360,10,1704276640,1704276640,1704293166,16526,FAILED
5313903,4,1,1704276700,1704276700,1704318704,42004,COMPLETED
5313904,360,10,1704276748,1704276749,1704293554,16805,FAILED
5313905,36,1,1704277063,1704277063,1704279823,2760,COMPLETED
5313906,360,10,1704277133,1704277134,1704293434,16300,FAILED
5313907,36,1,1704277501,1704277501,1704280555,3054,COMPLETED
5313908,1,1,1704278204,None,1704278245,0,CANCELLED by 1680352
5313909,1,1,1704278256,None,1704278257,0,CANCELLED by 1680352
5313910,72,2,1704278475,1704278475,1704284344,5869,CANCELLED by 45900
5313911,360,10,1704278692,1704278692,1704292135,13443,FAILED
5313913,360,10,1704278784,1704278785,1704398836,120051,FAILED
5313914,360,10,1704278856,1704278856,1704396996,118140,FAILED
5313915,36,1,1704278963,1704278965,1704279366,401,COMPLETED
5313916,36,1,1704278966,1704278969,1704282253,3284,COMPLETED
5313917,36,1,1704279016,1704279017,1704282307,3290,COMPLETED
5313918,36,1,1704279051,1704279051,1704283001,3950,COMPLETED
5313920,36,1,1704279082,1704279085,1704282869,3784,COMPLETED
5313924,36,1,1704279188,1704279189,1704279246,57,CANCELLED by 7504
5313925,36,1,1704279192,1704279193,1704279246,53,CANCELLED by 7504
5313926,36,1,1704279268,1704279269,1704279366,97,FAILED
5313928,36,1,1704279394,1704279394,1704322605,43211,TIMEOUT
5313933,1,1,1704279908,None,1704279915,0,CANCELLED by 1680352
5313936,36,1,1704280386,1704280387,1704281097,710,COMPLETED
5313937,36,1,1704280388,1704280391,1704281102,711,COMPLETED
5313938,36,1,1704280389,1704280391,1704281102,711,COMPLETED
5313939,36,1,1704280391,1704280428,1704281141,713,COMPLETED
5313940,36,1,1704280392,1704280428,1704281141,713,COMPLETED
5313941,36,1,1704280393,1704280556,1704281269,713,COMPLETED
5313942,36,1,1704280394,1704281098,1704281809,711,COMPLETED
5313943,36,1,1704280395,1704281103,1704281816,713,COMPLETED
5313944,1,1,1704280468,1704280468,1704280472,4,COMPLETED
5313946,36,1,1704280717,1704280717,1704362246,81529,COMPLETED
5313947_1,36,1,1704280772,1704281104,1704358510,77406,COMPLETED
5313947_2,36,1,1704280772,1704281142,1704367756,86614,COMPLETED
5313947_3,36,1,1704280772,1704281142,1704328168,47026,COMPLETED
5313950,1,1,1704281621,1704281622,1704281625,3,COMPLETED
5313951,1,1,1704281656,1704281657,1704281660,3,COMPLETED
5313952,1,1,1704281676,1704281677,1704281679,2,COMPLETED
5313953,1,1,1704281676,1704281677,1704281679,2,COMPLETED
5313954,1,1,1704281696,1704281697,1704281699,2,COMPLETED
5313955,9,1,1704281716,1704281717,1704281718,1,COMPLETED
5313956,9,1,1704281716,1704281717,1704281718,1,COMPLETED
5313957,1,1,1704281736,1704281736,1704281738,2,COMPLETED
5313958,18,1,1704281752,1704281752,1704288648,6896,COMPLETED
5313959,18,1,1704281752,1704281752,1704288647,6895,COMPLETED
5313960,1,1,1704281756,1704281756,1704281761,5,COMPLETED
5313961,1,1,1704281756,1704281756,1704281757,1,COMPLETED
5313962,1,1,1704281756,1704281756,1704281764,8,COMPLETED
5313963,1,1,1704281776,1704281776,1704281780,4,COMPLETED
5313964,432,12,1704282038,1704284350,1704298040,13690,CANCELLED by 46947
5313965,36,1,1704282100,1704282100,1704282673,573,COMPLETED
5313966,36,1,1704282176,1704282177,1704283232,1055,COMPLETED
5313967,36,1,1704282197,1704282197,1704282346,149,COMPLETED
5313968,36,1,1704282312,1704282313,1704282448,135,CANCELLED by 7504
5313969,36,1,1704282317,1704282318,1704282446,128,CANCELLED by 7504
5313970,4,1,1704282384,1704282385,1704292860,10475,COMPLETED
5313971,36,1,1704282468,1704282469,1704282675,206,FAILED
5313985,36,1,1704284156,1704284156,1704284159,3,FAILED
5313986,36,1,1704284257,1704284257,1704284261,4,COMPLETED
5313988,4,1,1704284456,1704284456,1704309647,25191,COMPLETED
5313989,72,2,1704284468,1704284469,1704287231,2762,CANCELLED by 45900
5313990_1,36,1,1704284514,1704284672,1704363571,78899,COMPLETED
5313990_2,36,1,1704284514,1704284672,1704335899,51227,COMPLETED
5313990_3,36,1,1704284514,1704284672,1704379351,94679,COMPLETED
5313994,4,1,1704285011,1704285012,1704310302,25290,COMPLETED
5313995,4,1,1704285351,1704285352,1704311959,26607,COMPLETED
5313996,4,1,1704285354,1704285356,1704311843,26487,COMPLETED
5313997,4,1,1704285356,1704285357,1704311673,26316,COMPLETED
5313998,4,1,1704285384,1704285385,1704319447,34062,COMPLETED
5313999,4,1,1704285386,1704285387,1704320032,34645,COMPLETED
5314000,4,1,1704285387,1704285387,1704319454,34067,COMPLETED
5314001,4,1,1704285389,1704285389,1704319569,34180,COMPLETED
5314002,4,1,1704285390,1704285393,1704319490,34097,COMPLETED
5314003,4,1,1704285406,1704285406,1704327983,42577,COMPLETED
5314004,4,1,1704285408,1704285410,1704330723,45313,COMPLETED
5314005,4,1,1704285409,1704285410,1704330746,45336,COMPLETED
5314006,4,1,1704285410,1704285414,1704330361,44947,COMPLETED
5314030,36,1,1704286608,1704287238,1704287959,721,COMPLETED
5314031,36,1,1704286610,1704287238,1704287954,716,COMPLETED
5314032,36,1,1704286611,1704287955,1704288674,719,COMPLETED
5314033,36,1,1704286612,1704287960,1704288682,722,COMPLETED
5314034,36,1,1704286613,1704288635,1704289358,723,COMPLETED
5314035,36,1,1704286614,1704288635,1704289354,719,COMPLETED
5314036,36,1,1704286615,1704288635,1704289355,720,COMPLETED
5314037,36,1,1704286616,1704288635,1704289354,719,COMPLETED
5314064,36,1,1704287520,1704288675,1704290508,1833,COMPLETED
5314070,288,8,1704288020,1704547422,1704548181,759,COMPLETED
5314065,288,8,1704288020,1704293167,1704336375,43208,TIMEOUT
5314066,288,8,1704288020,1704336386,1704379615,43229,TIMEOUT
5314067,288,8,1704288020,1704444642,1704487870,43228,TIMEOUT
5314068,288,8,1704288020,1704487881,1704531108,43227,TIMEOUT
5314069,288,8,1704288020,1704531119,1704547420,16301,COMPLETED
5314071,72,2,1704288171,1704289843,1704290545,702,CANCELLED by 45900
5314072,36,1,1704288840,None,1704288928,0,CANCELLED by 8510
5314073,1,1,1704288906,1704288907,1704288912,5,COMPLETED
5314075,1,1,1704288906,1704288907,1704288911,4,COMPLETED
5314074,1,1,1704288906,1704288907,1704288943,36,COMPLETED
5314076,1,1,1704288906,1704288907,1704288920,13,COMPLETED
5314077,1,1,1704288908,1704288910,1704288918,8,COMPLETED
5314078,36,1,1704288949,1704288949,1704288962,13,FAILED
5314079,36,1,1704288997,1704288998,1704289212,214,CANCELLED by 8510
5314080,1,1,1704289003,1704289003,1704289121,118,COMPLETED
5314081,1,1,1704289003,1704289003,1704289136,133,COMPLETED
5314083,1,1,1704289003,1704289003,1704289137,134,COMPLETED
5314084,1,1,1704289003,1704289003,1704289158,155,COMPLETED
5314085,1,1,1704289003,1704289003,1704289159,156,COMPLETED
5314082,2,1,1704289003,1704289003,1704290603,1600,COMPLETED
5314086,1,1,1704289003,1704289003,1704293468,4465,COMPLETED
5314089,1,1,1704289004,1704289007,1704289084,77,COMPLETED
5314088,1,1,1704289004,1704289007,1704289172,165,COMPLETED
5314090,1,1,1704289004,1704289007,1704289129,122,COMPLETED
5314087,2,1,1704289004,1704289007,1704290482,1475,COMPLETED
5314091,2,1,1704289004,1704289007,1704290244,1237,COMPLETED
5314092,2,1,1704289004,1704289007,1704290041,1034,COMPLETED
5314095,1,1,1704289005,1704289007,1704289079,72,COMPLETED
5314096,1,1,1704289005,1704289007,1704289067,60,COMPLETED
5314097,1,1,1704289005,1704289007,1704289042,35,COMPLETED
5314093,1,1,1704289005,1704289007,1704289157,150,COMPLETED
5314094,1,1,1704289005,1704289007,1704293851,4844,COMPLETED
5314100,1,1,1704289006,1704289007,1704289100,93,COMPLETED
5314099,1,1,1704289006,1704289007,1704289154,147,COMPLETED
5314103,1,1,1704289006,1704289007,1704289125,118,COMPLETED
5314098,1,1,1704289006,1704289007,1704294560,5553,COMPLETED
5314101,2,1,1704289006,1704289007,1704290523,1516,COMPLETED
5314102,2,1,1704289006,1704289007,1704290047,1040,COMPLETED
5314104,2,1,1704289006,1704289007,1704290131,1124,COMPLETED
5314105,2,1,1704289006,1704289007,1704290455,1448,COMPLETED
5314106,2,1,1704289006,1704289007,1704290321,1314,COMPLETED
5314110,1,1,1704289007,1704289007,1704289109,102,COMPLETED
5314111,1,1,1704289007,1704289011,1704289150,139,COMPLETED
5314107,2,1,1704289007,1704289007,1704290019,1012,COMPLETED
5314108,2,1,1704289007,1704289007,1704290189,1182,COMPLETED
5314109,2,1,1704289007,1704289007,1704290017,1010,COMPLETED
5314112,1,1,1704289008,1704289011,1704289094,83,COMPLETED
5314113,1,1,1704289008,1704289011,1704289117,106,COMPLETED
5314114,1,1,1704289008,1704289011,1704289178,167,COMPLETED
5314115,2,1,1704289008,1704289011,1704290366,1355,COMPLETED
5314118,1,1,1704289009,1704289011,1704289083,72,COMPLETED
5314119,1,1,1704289009,1704289011,1704289034,23,COMPLETED
5314117,1,1,1704289009,1704289011,1704289158,147,COMPLETED
5314121,1,1,1704289009,1704289011,1704289162,151,COMPLETED
5314122,1,1,1704289009,1704289011,1704289159,148,COMPLETED
5314116,2,1,1704289009,1704289011,1704290012,1001,COMPLETED
5314120,2,1,1704289009,1704289011,1704290189,1178,COMPLETED
5314125,1,1,1704289010,1704289011,1704289168,157,COMPLETED
5314126,1,1,1704289010,1704289011,1704289119,108,COMPLETED
5314127,1,1,1704289010,1704289011,1704289167,156,COMPLETED
5314130,1,1,1704289010,1704289011,1704289146,135,COMPLETED
5314123,2,1,1704289010,1704289011,1704290039,1028,COMPLETED
5314124,2,1,1704289010,1704289011,1704290248,1237,COMPLETED
5314128,2,1,1704289010,1704289011,1704290273,1262,COMPLETED
5314129,2,1,1704289010,1704289011,1704290074,1063,COMPLETED
5314134,1,1,1704289011,1704289011,1704289044,33,COMPLETED
5314136,1,1,1704289011,1704289015,1704289074,59,COMPLETED
5314131,1,1,1704289011,1704289011,1704289127,116,COMPLETED
5314133,1,1,1704289011,1704289011,1704289165,154,COMPLETED
5314132,2,1,1704289011,1704289011,1704290627,1616,COMPLETED
5314135,2,1,1704289011,1704289015,1704290281,1266,COMPLETED
5314137,1,1,1704289012,1704289015,1704289084,69,COMPLETED
5314138,1,1,1704289012,1704289015,1704289077,62,COMPLETED
5314139,1,1,1704289012,1704289015,1704293767,4752,COMPLETED
5314140,2,1,1704289012,1704289015,1704290508,1493,COMPLETED
5314142,1,1,1704289013,1704289015,1704289059,44,COMPLETED
5314144,2,1,1704289013,1704289015,1704289953,938,COMPLETED
5314141,1,1,1704289013,1704289015,1704294412,5397,COMPLETED
5314143,2,1,1704289013,1704289015,1704290510,1495,COMPLETED
5314152,2,1,1704289014,1704289015,1704289997,982,COMPLETED
5314145,2,1,1704289014,1704289015,1704290423,1408,COMPLETED
5314146,2,1,1704289014,1704289015,1704290067,1052,COMPLETED
5314147,1,1,1704289014,1704289015,1704293622,4607,COMPLETED
5314148,1,1,1704289014,1704289015,1704292961,3946,COMPLETED
5314149,1,1,1704289014,1704289015,1704292662,3647,COMPLETED
5314150,2,1,1704289014,1704289015,1704290054,1039,COMPLETED
5314151,2,1,1704289014,1704289015,1704290404,1389,COMPLETED
5314153,1,1,1704289014,1704289015,1704292941,3926,COMPLETED
5314154,2,1,1704289015,1704289015,1704290084,1069,COMPLETED
5314155,2,1,1704289015,1704289015,1704290404,1389,COMPLETED
5314156,1,1,1704289015,1704289015,1704293076,4061,COMPLETED
5314157,2,1,1704289015,1704289015,1704290382,1367,COMPLETED
5314158,1,1,1704289015,1704289015,1704292852,3837,COMPLETED
5314159,1,1,1704289015,1704289015,1704292874,3859,COMPLETED
5314160,2,1,1704289015,1704289015,1704290394,1379,COMPLETED
5314163,2,1,1704289016,1704289019,1704289965,946,COMPLETED
5314164,2,1,1704289016,1704289019,1704289944,925,COMPLETED
5314161,2,1,1704289016,1704289019,1704290376,1357,COMPLETED
5314162,2,1,1704289016,1704289019,1704290376,1357,COMPLETED
5314165,1,1,1704289016,1704289019,1704292959,3940,COMPLETED
5314166,2,1,1704289016,1704289019,1704290039,1020,COMPLETED
5314167,1,1,1704289016,1704289019,1704293044,4025,COMPLETED
5314168,2,1,1704289016,1704289019,1704290253,1234,COMPLETED
5314169,1,1,1704289016,1704289019,1704292517,3498,COMPLETED
5314170,2,1,1704289017,1704289019,1704290376,1357,COMPLETED
5314171,2,1,1704289017,1704289019,1704290527,1508,COMPLETED
5314172,2,1,1704289017,1704289019,1704290029,1010,COMPLETED
5314173,2,1,1704289017,1704289019,1704290024,1005,COMPLETED
5314174,2,1,1704289018,1704289019,1704290376,1357,COMPLETED
5314175,2,1,1704289018,1704289019,1704290042,1023,COMPLETED
5314176,1,1,1704289018,1704289019,1704293001,3982,COMPLETED
5314177,2,1,1704289018,1704289019,1704290027,1008,COMPLETED
5314178,2,1,1704289018,1704289019,1704290399,1380,COMPLETED
5314179,2,1,1704289018,1704289019,1704290473,1454,COMPLETED
5314180,2,1,1704289036,1704289036,1704289698,662,COMPLETED
5314181,2,1,1704289054,1704289054,1704289712,658,COMPLETED
5314182,1,1,1704289058,1704289058,1704291202,2144,COMPLETED
5314183,2,1,1704289069,1704289070,1704290323,1253,COMPLETED
5314184,2,1,1704289074,1704289075,1704289678,603,COMPLETED
5314186,2,1,1704289078,1704289078,1704289696,618,COMPLETED
5314185,1,1,1704289078,1704289078,1704291230,2152,COMPLETED
5314187,2,1,1704289094,1704289095,1704290323,1228,COMPLETED
5314188,36,1,1704289194,1704289217,1704289224,7,FAILED
5314189,36,1,1704289259,1704289359,1704290132,773,CANCELLED by 8510
5314190,36,1,1704289716,1704289816,1704290881,1065,COMPLETED
5314191,36,1,1704289752,1704289816,1704290230,414,COMPLETED
5314192,36,1,1704290122,1704290125,1704290133,8,FAILED
5314193,36,1,1704290144,1704290144,1704290147,3,FAILED
5314194,36,1,1704290162,1704290162,1704290169,7,FAILED
5314195,36,1,1704290600,1704290600,1704291519,919,TIMEOUT
5314196,72,2,1704290868,1704290882,1704291402,520,COMPLETED
5314197,36,1,1704291056,1704291403,1704291429,26,FAILED
5314198,36,1,1704291348,1704291403,1704312677,21274,COMPLETED
5314199,144,4,1704291805,1704292137,1704292577,440,COMPLETED
5314200,36,1,1704292254,1704292255,1704378684,86429,TIMEOUT
5314201,36,1,1704292308,1704292309,1704292889,580,FAILED
5314202,36,1,1704292939,1704292939,1704296914,3975,COMPLETED
5314203,1,1,1704292979,1704292980,1704293052,72,COMPLETED
5314205,1,1,1704292979,1704292980,1704293052,72,COMPLETED
5314204,1,1,1704292979,1704292980,1704293092,112,COMPLETED
5314206,1,1,1704292980,1704292980,1704293054,74,COMPLETED
5314207,1,1,1704292980,1704292980,1704293052,72,COMPLETED
5314208,1,1,1704292980,1704292980,1704293052,72,COMPLETED
5314209,1,1,1704292980,1704292980,1704293060,80,COMPLETED
5314210,1,1,1704292980,1704292980,1704293062,82,COMPLETED
5314211,1,1,1704292980,1704292980,1704293057,77,COMPLETED
5314212,1,1,1704292980,1704292980,1704293052,72,COMPLETED
5314213,1,1,1704292980,1704292980,1704293052,72,COMPLETED
5314214,1,1,1704292980,1704292980,1704293052,72,COMPLETED
5314215,1,1,1704292980,1704292980,1704293062,82,COMPLETED
5314216,1,1,1704292980,1704292980,1704293052,72,COMPLETED
5314217,1,1,1704292980,1704292984,1704293062,78,COMPLETED
5314218,1,1,1704292980,1704292984,1704293059,75,COMPLETED
5314219,1,1,1704292980,1704292984,1704293054,70,COMPLETED
5314220,1,1,1704292980,1704292984,1704293052,68,COMPLETED
5314221,1,1,1704292980,1704292984,1704293052,68,COMPLETED
5314222,1,1,1704292980,1704292984,1704293059,75,COMPLETED
5314223,1,1,1704292981,1704292984,1704293057,73,COMPLETED
5314224,1,1,1704292981,1704292984,1704293062,78,COMPLETED
5314225,1,1,1704292981,1704292984,1704293052,68,COMPLETED
5314226,1,1,1704292981,1704292984,1704293054,70,COMPLETED
5314227,1,1,1704292981,1704292984,1704293052,68,COMPLETED
5314228,1,1,1704292981,1704292984,1704293052,68,COMPLETED
5314229,1,1,1704292981,1704292984,1704293052,68,COMPLETED
5314230,1,1,1704292981,1704292984,1704293052,68,COMPLETED
5314231,1,1,1704292981,1704292984,1704293052,68,COMPLETED
5314232,1,1,1704292981,1704292984,1704293052,68,COMPLETED
5314233,1,1,1704292981,1704292984,1704293064,80,COMPLETED
5314234,1,1,1704292981,1704292984,1704293052,68,COMPLETED
5314235,1,1,1704292981,1704292984,1704293052,68,COMPLETED
5314236,1,1,1704292981,1704292984,1704293052,68,COMPLETED
5314237,1,1,1704292981,1704292984,1704293052,68,COMPLETED
5314238,1,1,1704292981,1704292984,1704293052,68,COMPLETED
5314239,1,1,1704292981,1704292984,1704293052,68,COMPLETED
5314240,1,1,1704292981,1704292984,1704293052,68,COMPLETED
5314241,1,1,1704292981,1704292984,1704293054,70,COMPLETED
5314242,1,1,1704292981,1704292984,1704293063,79,COMPLETED
5314243,1,1,1704292982,1704292984,1704293052,68,COMPLETED
5314244,1,1,1704292982,1704292984,1704293052,68,COMPLETED
5314245,1,1,1704292982,1704292984,1704293057,73,COMPLETED
5314246,1,1,1704292982,1704292984,1704293054,70,COMPLETED
5314247,1,1,1704292982,1704292984,1704293063,79,COMPLETED
5314248,1,1,1704292982,1704292984,1704293052,68,COMPLETED
5314249,1,1,1704292982,1704292984,1704293052,68,COMPLETED
5314250,1,1,1704292982,1704292984,1704293062,78,COMPLETED
5314251,1,1,1704292982,1704292984,1704293057,73,COMPLETED
5314252,1,1,1704292982,1704292984,1704293052,68,COMPLETED
5314253,1,1,1704292982,1704292984,1704293062,78,COMPLETED
5314254,1,1,1704292982,1704292984,1704293061,77,COMPLETED
5314255,1,1,1704292983,1704292984,1704293054,70,COMPLETED
5314256,1,1,1704292983,1704292984,1704293061,77,COMPLETED
5314257,1,1,1704292983,1704292984,1704293057,73,COMPLETED
5314258,1,1,1704292983,1704292984,1704293054,70,COMPLETED
5314259,1,1,1704292983,1704292984,1704293052,68,COMPLETED
5314260,1,1,1704292983,1704292984,1704293052,68,COMPLETED
5314261,1,1,1704292983,1704292984,1704293052,68,COMPLETED
5314262,1,1,1704292983,1704292984,1704293052,68,COMPLETED
5314263,1,1,1704292983,1704292984,1704293059,75,COMPLETED
5314264,1,1,1704292983,1704292984,1704293052,68,COMPLETED
5314265,1,1,1704292983,1704292984,1704293052,68,COMPLETED
5314266,1,1,1704292983,1704292984,1704293061,77,COMPLETED
5314267,1,1,1704292983,1704292984,1704293052,68,COMPLETED
5314268,1,1,1704292983,1704292984,1704293052,68,COMPLETED
5314269,1,1,1704292983,1704292984,1704293062,78,COMPLETED
5314270,1,1,1704292983,1704292984,1704293052,68,COMPLETED
5314271,1,1,1704292983,1704292984,1704293059,75,COMPLETED
5314272,1,1,1704292983,1704292984,1704293052,68,COMPLETED
5314273,1,1,1704292983,1704292984,1704293052,68,COMPLETED
5314274,1,1,1704292984,1704292984,1704293052,68,COMPLETED
5314275,1,1,1704292984,1704292984,1704293052,68,COMPLETED
5314276,1,1,1704292984,1704292984,1704293052,68,COMPLETED
5314277,1,1,1704292984,1704292984,1704293052,68,COMPLETED
5314278,1,1,1704292984,1704292984,1704293052,68,COMPLETED
5314279,1,1,1704292984,1704292984,1704293052,68,COMPLETED
5314280,1,1,1704292984,1704292984,1704293054,70,COMPLETED
5314281,1,1,1704292984,1704292984,1704293052,68,COMPLETED
5314282,1,1,1704292984,1704292984,1704293062,78,COMPLETED
5314283,1,1,1704292984,1704292984,1704293052,68,COMPLETED
5314284,1,1,1704292984,1704292984,1704293052,68,COMPLETED
5314285,1,1,1704292984,1704292984,1704293052,68,COMPLETED
5314286,1,1,1704292984,1704292984,1704293059,75,COMPLETED
5314287,1,1,1704292984,1704292988,1704293063,75,COMPLETED
5314288,1,1,1704292984,1704292988,1704293052,64,COMPLETED
5314289,1,1,1704292984,1704292988,1704293062,74,COMPLETED
5314290,1,1,1704292985,1704292988,1704293052,64,COMPLETED
5314291,1,1,1704292985,1704292988,1704293052,64,COMPLETED
5314292,1,1,1704292985,1704292988,1704293052,64,COMPLETED
5314293,1,1,1704292985,1704292988,1704293062,74,COMPLETED
5314294,1,1,1704292985,1704292988,1704293052,64,COMPLETED
5314295,1,1,1704292985,1704292988,1704293052,64,COMPLETED
5314296,1,1,1704292985,1704292988,1704293052,64,COMPLETED
5314297,1,1,1704292985,1704292988,1704293052,64,COMPLETED
5314298,1,1,1704292985,1704292988,1704293060,72,COMPLETED
5314299,1,1,1704292985,1704292988,1704293052,64,COMPLETED
5314300,1,1,1704292985,1704292988,1704293052,64,COMPLETED
5314301,1,1,1704292985,1704292988,1704293052,64,COMPLETED
5314302,1,1,1704292985,1704292988,1704293060,72,COMPLETED
5314303,1,1,1704292985,1704292988,1704293052,64,COMPLETED
5314304,1,1,1704292985,1704292988,1704293052,64,COMPLETED
5314305,1,1,1704292985,1704292988,1704293060,72,COMPLETED
5314306,1,1,1704292985,1704292988,1704293052,64,COMPLETED
5314307,1,1,1704292985,1704292988,1704293059,71,COMPLETED
5314308,1,1,1704292985,1704292988,1704293059,71,COMPLETED
5314309,1,1,1704292985,1704292988,1704293052,64,COMPLETED
5314310,1,1,1704292986,1704292988,1704293054,66,COMPLETED
5314311,1,1,1704292986,1704292988,1704293052,64,COMPLETED
5314312,1,1,1704292986,1704292988,1704293059,71,COMPLETED
5314313,1,1,1704292986,1704292988,1704293052,64,COMPLETED
5314314,1,1,1704292986,1704292988,1704293054,66,COMPLETED
5314315,1,1,1704292986,1704292988,1704293052,64,COMPLETED
5314316,1,1,1704292986,1704292988,1704293052,64,COMPLETED
5314317,1,1,1704292986,1704292988,1704293052,64,COMPLETED
5314318,1,1,1704292986,1704292988,1704293052,64,COMPLETED
5314319,1,1,1704292986,1704292988,1704293052,64,COMPLETED
5314320,1,1,1704292986,1704292988,1704293057,69,COMPLETED
5314321,1,1,1704292986,1704292988,1704293054,66,COMPLETED
5314322,1,1,1704292986,1704292988,1704293054,66,COMPLETED
5314323,1,1,1704292986,1704292988,1704293052,64,COMPLETED
5314324,1,1,1704292986,1704292988,1704293057,69,COMPLETED
5314325,1,1,1704292986,1704292988,1704293052,64,COMPLETED
5314326,1,1,1704292986,1704292988,1704293059,71,COMPLETED
5314327,1,1,1704292986,1704292988,1704293052,64,COMPLETED
5314328,1,1,1704292986,1704292988,1704293054,66,COMPLETED
5314329,1,1,1704292986,1704292988,1704293059,71,COMPLETED
5314330,1,1,1704292986,1704292988,1704293061,73,COMPLETED
5314331,1,1,1704292986,1704292988,1704293052,64,COMPLETED
5314332,1,1,1704292986,1704292988,1704293064,76,COMPLETED
5314333,1,1,1704292986,1704292988,1704293052,64,COMPLETED
5314334,1,1,1704292986,1704292988,1704293052,64,COMPLETED
5314335,1,1,1704292986,1704292988,1704293052,64,COMPLETED
5314336,1,1,1704292987,1704292988,1704293052,64,COMPLETED
5314337,1,1,1704292987,1704292988,1704293052,64,COMPLETED
5314338,1,1,1704292987,1704292988,1704293052,64,COMPLETED
5314339,1,1,1704292987,1704292988,1704293054,66,COMPLETED
5314340,1,1,1704292987,1704292988,1704293052,64,COMPLETED
5314341,1,1,1704292987,1704292988,1704293052,64,COMPLETED
5314342,1,1,1704292987,1704292988,1704293052,64,COMPLETED
5314343,1,1,1704292987,1704292988,1704293054,66,COMPLETED
5314344,1,1,1704292987,1704292988,1704293058,70,COMPLETED
5314345,1,1,1704292987,1704292988,1704293052,64,COMPLETED
5314346,1,1,1704292987,1704292988,1704293052,64,COMPLETED
5314347,1,1,1704292987,1704292988,1704293052,64,COMPLETED
5314348,1,1,1704292987,1704292988,1704293054,66,COMPLETED
5314349,1,1,1704292987,1704292988,1704293052,64,COMPLETED
5314350,1,1,1704292987,1704292988,1704293052,64,COMPLETED
5314351,1,1,1704292987,1704292988,1704293054,66,COMPLETED
5314352,1,1,1704292987,1704292988,1704293052,64,COMPLETED
5314353,1,1,1704292987,1704292988,1704293052,64,COMPLETED
5314354,1,1,1704292987,1704292988,1704293052,64,COMPLETED
5314355,1,1,1704292988,1704292988,1704293054,66,COMPLETED
5314356,1,1,1704292988,1704292988,1704293054,66,COMPLETED
5314357,1,1,1704292988,1704292988,1704293052,64,COMPLETED
5314358,1,1,1704292988,1704292988,1704293052,64,COMPLETED
5314359,1,1,1704292988,1704292988,1704293054,66,COMPLETED
5314360,1,1,1704292988,1704292988,1704293059,71,COMPLETED
5314361,1,1,1704292988,1704292988,1704293052,64,COMPLETED
5314362,1,1,1704292988,1704292988,1704293052,64,COMPLETED
5314363,1,1,1704292988,1704292992,1704293054,62,COMPLETED
5314364,1,1,1704292988,1704292992,1704293054,62,COMPLETED
5314365,1,1,1704292989,1704292992,1704293057,65,COMPLETED
5314366,1,1,1704292989,1704292992,1704293054,62,COMPLETED
5314367,1,1,1704292989,1704292992,1704293058,66,COMPLETED
5314368,1,1,1704292989,1704292992,1704293057,65,COMPLETED
5314369,1,1,1704292989,1704292992,1704293052,60,COMPLETED
5314370,1,1,1704292989,1704292992,1704293052,60,COMPLETED
5314371,1,1,1704292989,1704292992,1704293052,60,COMPLETED
5314372,1,1,1704292989,1704292992,1704293062,70,COMPLETED
5314373,1,1,1704292989,1704292992,1704293054,62,COMPLETED
5314374,1,1,1704292990,1704292992,1704293052,60,COMPLETED
5314375,1,1,1704292990,1704292992,1704293052,60,COMPLETED
5314376,1,1,1704292990,1704292992,1704293052,60,COMPLETED
5314377,1,1,1704292990,1704292992,1704293052,60,COMPLETED
5314378,1,1,1704292990,1704292992,1704293052,60,COMPLETED
5314379,1,1,1704292990,1704292992,1704293052,60,COMPLETED
5314380,1,1,1704292990,1704292992,1704293052,60,COMPLETED
5314381,1,1,1704292990,1704292992,1704293052,60,COMPLETED
5314382,1,1,1704292990,1704292992,1704293052,60,COMPLETED
5314383,1,1,1704292990,1704292992,1704293052,60,COMPLETED
5314384,1,1,1704292990,1704292992,1704293052,60,COMPLETED
5314385,1,1,1704292990,1704292992,1704293052,60,COMPLETED
5314386,1,1,1704293456,1704293457,1704293514,57,COMPLETED
5314387,1,1,1704293456,1704293457,1704293521,64,COMPLETED
5314388,1,1,1704293456,1704293457,1704293521,64,COMPLETED
5314389,1,1,1704293456,1704293457,1704293514,57,COMPLETED
5314390,1,1,1704293456,1704293457,1704293514,57,COMPLETED
5314391,1,1,1704293457,1704293457,1704293515,58,COMPLETED
5314392,1,1,1704293457,1704293457,1704293514,57,COMPLETED
5314393,1,1,1704293457,1704293457,1704293514,57,COMPLETED
5314394,1,1,1704293457,1704293457,1704293514,57,COMPLETED
5314395,1,1,1704293457,1704293461,1704293514,53,COMPLETED
5314396,1,1,1704293457,1704293461,1704293514,53,COMPLETED
5314397,1,1,1704293457,1704293461,1704293514,53,COMPLETED
5314398,1,1,1704293457,1704293461,1704293515,54,COMPLETED
5314399,1,1,1704293457,1704293461,1704293515,54,COMPLETED
5314400,1,1,1704293457,1704293461,1704293514,53,COMPLETED
5314401,1,1,1704293457,1704293461,1704293515,54,COMPLETED
5314402,1,1,1704293457,1704293461,1704293515,54,COMPLETED
5314403,1,1,1704293457,1704293461,1704293514,53,COMPLETED
5314404,1,1,1704293457,1704293461,1704293514,53,COMPLETED
5314405,1,1,1704293458,1704293461,1704293514,53,COMPLETED
5314406,1,1,1704293458,1704293461,1704293514,53,COMPLETED
5314407,1,1,1704293458,1704293461,1704293514,53,COMPLETED
5314408,1,1,1704293458,1704293461,1704293514,53,COMPLETED
5314409,1,1,1704293458,1704293461,1704293514,53,COMPLETED
5314410,1,1,1704293458,1704293461,1704293514,53,COMPLETED
5314411,1,1,1704293458,1704293461,1704293514,53,COMPLETED
5314412,1,1,1704293458,1704293461,1704293514,53,COMPLETED
5314413,1,1,1704293458,1704293461,1704293514,53,COMPLETED
5314414,1,1,1704293458,1704293461,1704293514,53,COMPLETED
5314415,1,1,1704293458,1704293461,1704293514,53,COMPLETED
5314416,1,1,1704293458,1704293461,1704293516,55,COMPLETED
5314417,1,1,1704293458,1704293461,1704293515,54,COMPLETED
5314418,1,1,1704293458,1704293461,1704293514,53,COMPLETED
5314419,1,1,1704293458,1704293461,1704293514,53,COMPLETED
5314420,1,1,1704293458,1704293461,1704293514,53,COMPLETED
5314421,1,1,1704293458,1704293461,1704293514,53,COMPLETED
5314422,1,1,1704293458,1704293461,1704293520,59,COMPLETED
5314423,1,1,1704293458,1704293461,1704293515,54,COMPLETED
5314424,1,1,1704293459,1704293461,1704293514,53,COMPLETED
5314425,1,1,1704293459,1704293461,1704293514,53,COMPLETED
5314426,1,1,1704293459,1704293461,1704293519,58,COMPLETED
5314427,1,1,1704293459,1704293461,1704293514,53,COMPLETED
5314428,1,1,1704293459,1704293461,1704293515,54,COMPLETED
5314429,1,1,1704293459,1704293461,1704293514,53,COMPLETED
5314430,1,1,1704293459,1704293461,1704293514,53,COMPLETED
5314431,1,1,1704293459,1704293461,1704293514,53,COMPLETED
5314432,1,1,1704293459,1704293461,1704293514,53,COMPLETED
5314433,1,1,1704293459,1704293461,1704293519,58,COMPLETED
5314434,1,1,1704293459,1704293461,1704293514,53,COMPLETED
5314435,1,1,1704293459,1704293461,1704293514,53,COMPLETED
5314436,1,1,1704293459,1704293461,1704293514,53,COMPLETED
5314437,1,1,1704293459,1704293461,1704293514,53,COMPLETED
5314438,1,1,1704293459,1704293461,1704293516,55,COMPLETED
5314439,1,1,1704293459,1704293461,1704293515,54,COMPLETED
5314440,1,1,1704293459,1704293461,1704293514,53,COMPLETED
5314441,1,1,1704293459,1704293461,1704293514,53,COMPLETED
5314442,1,1,1704293459,1704293461,1704293514,53,COMPLETED
5314443,1,1,1704293460,1704293461,1704293519,58,COMPLETED
5314444,1,1,1704293460,1704293461,1704293514,53,COMPLETED
5314445,1,1,1704293460,1704293461,1704293514,53,COMPLETED
5314446,1,1,1704293460,1704293461,1704293514,53,COMPLETED
5314447,1,1,1704293460,1704293461,1704293514,53,COMPLETED
5314448,1,1,1704293460,1704293461,1704293514,53,COMPLETED
5314449,1,1,1704293460,1704293461,1704293514,53,COMPLETED
5314450,1,1,1704293460,1704293461,1704293514,53,COMPLETED
5314451,1,1,1704293460,1704293461,1704293514,53,COMPLETED
5314452,1,1,1704293460,1704293461,1704293514,53,COMPLETED
5314453,1,1,1704293460,1704293461,1704293516,55,COMPLETED
5314454,1,1,1704293460,1704293461,1704293514,53,COMPLETED
5314455,1,1,1704293460,1704293461,1704293516,55,COMPLETED
5314456,1,1,1704293460,1704293461,1704293514,53,COMPLETED
5314457,1,1,1704293460,1704293461,1704293515,54,COMPLETED
5314458,1,1,1704293460,1704293461,1704293514,53,COMPLETED
5314459,1,1,1704293460,1704293461,1704293516,55,COMPLETED
5314460,1,1,1704293460,1704293461,1704293514,53,COMPLETED
5314461,1,1,1704293460,1704293461,1704293517,56,COMPLETED
5314462,1,1,1704293460,1704293461,1704293514,53,COMPLETED
5314463,1,1,1704293460,1704293461,1704293514,53,COMPLETED
5314464,1,1,1704293460,1704293461,1704293514,53,COMPLETED
5314465,1,1,1704293460,1704293461,1704293514,53,COMPLETED
5314466,1,1,1704293461,1704293461,1704293514,53,COMPLETED
5314467,1,1,1704293461,1704293461,1704293514,53,COMPLETED
5314468,1,1,1704293461,1704293461,1704293519,58,COMPLETED
5314469,1,1,1704293461,1704293461,1704293515,54,COMPLETED
5314470,1,1,1704293461,1704293461,1704293514,53,COMPLETED
5314471,1,1,1704293461,1704293461,1704293514,53,COMPLETED
5314472,1,1,1704293461,1704293461,1704293514,53,COMPLETED
5314473,1,1,1704293461,1704293461,1704293515,54,COMPLETED
5314474,1,1,1704293461,1704293461,1704293515,54,COMPLETED
5314475,1,1,1704293461,1704293465,1704293514,49,COMPLETED
5314476,1,1,1704293461,1704293465,1704293516,51,COMPLETED
5314477,1,1,1704293461,1704293465,1704293517,52,COMPLETED
5314478,1,1,1704293461,1704293465,1704293515,50,COMPLETED
5314479,1,1,1704293461,1704293465,1704293514,49,COMPLETED
5314480,1,1,1704293462,1704293465,1704293520,55,COMPLETED
5314481,1,1,1704293462,1704293465,1704293514,49,COMPLETED
5314482,1,1,1704293462,1704293465,1704293515,50,COMPLETED
5314483,1,1,1704293462,1704293465,1704293514,49,COMPLETED
5314484,1,1,1704293462,1704293465,1704293514,49,COMPLETED
5314485,1,1,1704293462,1704293465,1704293514,49,COMPLETED
5314486,1,1,1704293462,1704293465,1704293514,49,COMPLETED
5314487,1,1,1704293462,1704293465,1704293515,50,COMPLETED
5314488,1,1,1704293462,1704293465,1704293515,50,COMPLETED
5314489,1,1,1704293462,1704293465,1704293516,51,COMPLETED
5314490,1,1,1704293462,1704293465,1704293514,49,COMPLETED
5314491,1,1,1704293462,1704293465,1704293514,49,COMPLETED
5314492,1,1,1704293462,1704293465,1704293514,49,COMPLETED
5314493,1,1,1704293462,1704293465,1704293514,49,COMPLETED
5314494,1,1,1704293462,1704293465,1704293514,49,COMPLETED
5314495,1,1,1704293462,1704293465,1704293514,49,COMPLETED
5314496,1,1,1704293462,1704293465,1704293516,51,COMPLETED
5314497,1,1,1704293462,1704293465,1704293516,51,COMPLETED
5314498,1,1,1704293463,1704293465,1704293514,49,COMPLETED
5314499,1,1,1704293463,1704293465,1704293514,49,COMPLETED
5314500,1,1,1704293463,1704293465,1704293520,55,COMPLETED
5314501,1,1,1704293463,1704293465,1704293523,58,COMPLETED
5314502,1,1,1704293463,1704293465,1704293514,49,COMPLETED
5314503,1,1,1704293463,1704293465,1704293514,49,COMPLETED
5314504,1,1,1704293463,1704293465,1704293514,49,COMPLETED
5314505,1,1,1704293463,1704293465,1704293514,49,COMPLETED
5314506,1,1,1704293463,1704293465,1704293514,49,COMPLETED
5314507,1,1,1704293463,1704293465,1704293519,54,COMPLETED
5314508,1,1,1704293463,1704293465,1704293514,49,COMPLETED
5314509,1,1,1704293463,1704293465,1704293514,49,COMPLETED
5314510,1,1,1704293463,1704293465,1704293514,49,COMPLETED
5314511,1,1,1704293463,1704293465,1704293514,49,COMPLETED
5314512,1,1,1704293463,1704293465,1704293515,50,COMPLETED
5314513,1,1,1704293463,1704293465,1704293514,49,COMPLETED
5314514,1,1,1704293463,1704293465,1704293520,55,COMPLETED
5314515,1,1,1704293464,1704293465,1704293514,49,COMPLETED
5314516,1,1,1704293464,1704293465,1704293514,49,COMPLETED
5314517,1,1,1704293464,1704293465,1704293516,51,COMPLETED
5314518,1,1,1704293464,1704293465,1704293515,50,COMPLETED
5314519,1,1,1704293464,1704293465,1704293545,80,COMPLETED
5314520,1,1,1704293464,1704293465,1704293514,49,COMPLETED
5314521,1,1,1704293464,1704293465,1704293514,49,COMPLETED
5314522,1,1,1704293464,1704293465,1704293514,49,COMPLETED
5314523,1,1,1704293464,1704293465,1704293515,50,COMPLETED
5314524,1,1,1704293464,1704293465,1704293514,49,COMPLETED
5314525,1,1,1704293464,1704293465,1704293515,50,COMPLETED
5314526,1,1,1704293464,1704293465,1704293514,49,COMPLETED
5314527,1,1,1704293464,1704293465,1704293515,50,COMPLETED
5314528,1,1,1704293464,1704293465,1704293514,49,COMPLETED
5314529,1,1,1704293464,1704293465,1704293515,50,COMPLETED
5314530,1,1,1704293464,1704293465,1704293514,49,COMPLETED
5314531,1,1,1704293464,1704293465,1704293515,50,COMPLETED
5314532,1,1,1704293464,1704293465,1704293514,49,COMPLETED
5314533,1,1,1704293464,1704293465,1704293514,49,COMPLETED
5314534,1,1,1704293465,1704293465,1704293514,49,COMPLETED
5314535,1,1,1704293465,1704293465,1704293514,49,COMPLETED
5314536,1,1,1704293465,1704293465,1704293514,49,COMPLETED
5314537,1,1,1704293465,1704293465,1704293514,49,COMPLETED
5314538,1,1,1704293465,1704293465,1704293514,49,COMPLETED
5314539,1,1,1704293465,1704293465,1704293514,49,COMPLETED
5314540,1,1,1704293465,1704293465,1704293516,51,COMPLETED
5314541,1,1,1704293465,1704293465,1704293519,54,COMPLETED
5314542,1,1,1704293465,1704293465,1704293514,49,COMPLETED
5314543,1,1,1704293465,1704293465,1704293516,51,COMPLETED
5314544,1,1,1704293465,1704293465,1704293514,49,COMPLETED
5314545,1,1,1704293465,1704293465,1704293514,49,COMPLETED
5314546,1,1,1704293465,1704293465,1704293514,49,COMPLETED
5314547,1,1,1704293465,1704293465,1704293514,49,COMPLETED
5314548,1,1,1704293465,1704293469,1704293519,50,COMPLETED
5314549,1,1,1704293465,1704293469,1704293514,45,COMPLETED
5314550,1,1,1704293465,1704293469,1704293515,46,COMPLETED
5314551,1,1,1704293465,1704293469,1704293516,47,COMPLETED
5314552,1,1,1704293466,1704293469,1704293514,45,COMPLETED
5314553,1,1,1704293466,1704293469,1704293519,50,COMPLETED
5314554,1,1,1704293466,1704293469,1704293514,45,COMPLETED
5314555,1,1,1704293466,1704293469,1704293514,45,COMPLETED
5314556,1,1,1704293466,1704293469,1704293514,45,COMPLETED
5314557,36,1,1704293572,1704293572,1704294134,562,FAILED
5314558,1,1,1704293912,1704293913,1704293962,49,COMPLETED
5314559,1,1,1704293913,1704293913,1704293968,55,COMPLETED
5314560,1,1,1704293913,1704293913,1704293964,51,COMPLETED
5314561,1,1,1704293913,1704293913,1704293966,53,COMPLETED
5314562,1,1,1704293913,1704293913,1704293966,53,COMPLETED
5314563,1,1,1704293913,1704293913,1704293966,53,COMPLETED
5314564,1,1,1704293913,1704293913,1704293967,54,COMPLETED
5314565,1,1,1704293913,1704293913,1704293964,51,COMPLETED
5314566,1,1,1704293913,1704293913,1704293984,71,COMPLETED
5314567,1,1,1704293913,1704293913,1704293962,49,COMPLETED
5314568,1,1,1704293913,1704293913,1704293964,51,COMPLETED
5314569,1,1,1704293913,1704293913,1704293966,53,COMPLETED
5314570,1,1,1704293913,1704293913,1704293966,53,COMPLETED
5314571,1,1,1704293913,1704293913,1704293962,49,COMPLETED
5314572,1,1,1704293913,1704293918,1704293966,48,COMPLETED
5314573,1,1,1704293913,1704293918,1704293964,46,COMPLETED
5314574,1,1,1704293913,1704293918,1704293967,49,COMPLETED
5314575,1,1,1704293913,1704293918,1704293964,46,COMPLETED
5314576,1,1,1704293913,1704293918,1704293966,48,COMPLETED
5314577,1,1,1704293914,1704293918,1704293966,48,COMPLETED
5314578,1,1,1704293914,1704293918,1704293964,46,COMPLETED
5314579,1,1,1704293914,1704293918,1704293964,46,COMPLETED
5314580,1,1,1704293914,1704293918,1704293964,46,COMPLETED
5314581,1,1,1704293914,1704293918,1704293962,44,COMPLETED
5314582,1,1,1704293914,1704293918,1704293968,50,COMPLETED
5314583,1,1,1704293914,1704293918,1704293967,49,COMPLETED
5314584,1,1,1704293914,1704293918,1704293964,46,COMPLETED
5314585,1,1,1704293914,1704293918,1704293968,50,COMPLETED
5314586,1,1,1704293914,1704293918,1704293966,48,COMPLETED
5314587,1,1,1704293914,1704293918,1704293966,48,COMPLETED
5314588,1,1,1704293914,1704293918,1704293966,48,COMPLETED
5314589,1,1,1704293914,1704293918,1704293964,46,COMPLETED
5314590,1,1,1704293914,1704293918,1704293966,48,COMPLETED
5314591,1,1,1704293914,1704293918,1704293966,48,COMPLETED
5314592,1,1,1704293914,1704293918,1704293964,46,COMPLETED
5314593,1,1,1704293914,1704293918,1704293962,44,COMPLETED
5314594,1,1,1704293914,1704293918,1704293966,48,COMPLETED
5314595,1,1,1704293914,1704293918,1704293962,44,COMPLETED
5314596,1,1,1704293914,1704293918,1704293964,46,COMPLETED
5314597,1,1,1704293915,1704293918,1704293964,46,COMPLETED
5314598,1,1,1704293915,1704293918,1704293966,48,COMPLETED
5314599,1,1,1704293915,1704293918,1704293964,46,COMPLETED
5314600,1,1,1704293915,1704293918,1704293964,46,COMPLETED
5314601,1,1,1704293915,1704293918,1704293962,44,COMPLETED
5314602,1,1,1704293915,1704293918,1704293968,50,COMPLETED
5314603,1,1,1704293915,1704293918,1704293965,47,COMPLETED
5314604,1,1,1704293915,1704293918,1704293970,52,COMPLETED
5314605,1,1,1704293915,1704293918,1704293968,50,COMPLETED
5314606,1,1,1704293915,1704293918,1704293962,44,COMPLETED
5314607,1,1,1704293915,1704293918,1704293962,44,COMPLETED
5314608,1,1,1704293915,1704293918,1704293964,46,COMPLETED
5314609,1,1,1704293916,1704293918,1704293964,46,COMPLETED
5314610,1,1,1704293916,1704293918,1704293964,46,COMPLETED
5314611,1,1,1704293916,1704293918,1704293970,52,COMPLETED
5314612,1,1,1704293916,1704293918,1704293964,46,COMPLETED
5314613,1,1,1704293916,1704293918,1704293964,46,COMPLETED
5314614,1,1,1704293916,1704293918,1704293964,46,COMPLETED
5314615,1,1,1704293917,1704293918,1704293965,47,COMPLETED
5314616,1,1,1704293917,1704293918,1704293968,50,COMPLETED
5314617,1,1,1704293917,1704293918,1704293974,56,COMPLETED
5314618,1,1,1704293917,1704293918,1704293964,46,COMPLETED
5314619,1,1,1704293917,1704293918,1704293964,46,COMPLETED
5314620,1,1,1704293917,1704293918,1704293964,46,COMPLETED
5314621,1,1,1704293917,1704293918,1704293962,44,COMPLETED
5314622,1,1,1704293917,1704293918,1704293968,50,COMPLETED
5314623,1,1,1704293917,1704293918,1704293968,50,COMPLETED
5314624,1,1,1704293917,1704293918,1704293968,50,COMPLETED
5314625,1,1,1704293917,1704293918,1704293965,47,COMPLETED
5314626,1,1,1704293918,1704293918,1704293966,48,COMPLETED
5314627,1,1,1704293918,1704293918,1704293965,47,COMPLETED
5314628,1,1,1704293918,1704293918,1704293962,44,COMPLETED
5314629,1,1,1704293918,1704293918,1704293968,50,COMPLETED
5314630,1,1,1704293918,1704293918,1704293962,44,COMPLETED
5314631,1,1,1704293918,1704293922,1704293964,42,COMPLETED
5314632,1,1,1704293918,1704293922,1704293964,42,COMPLETED
5314633,1,1,1704293918,1704293922,1704293965,43,COMPLETED
5314634,1,1,1704293919,1704293922,1704293962,40,COMPLETED
5314635,1,1,1704293919,1704293922,1704293968,46,COMPLETED
5314636,1,1,1704293919,1704293922,1704293962,40,COMPLETED
5314637,1,1,1704293919,1704293922,1704293968,46,COMPLETED
5314638,1,1,1704293919,1704293922,1704293964,42,COMPLETED
5314639,1,1,1704293919,1704293922,1704293965,43,COMPLETED
5314640,1,1,1704293919,1704293922,1704293968,46,COMPLETED
5314641,1,1,1704293919,1704293922,1704293962,40,COMPLETED
5314642,1,1,1704293919,1704293922,1704293964,42,COMPLETED
5314643,1,1,1704293919,1704293922,1704293964,42,COMPLETED
5314644,1,1,1704293919,1704293922,1704293962,40,COMPLETED
5314645,1,1,1704293919,1704293922,1704293962,40,COMPLETED
5314646,1,1,1704293919,1704293922,1704293962,40,COMPLETED
5314647,1,1,1704293919,1704293922,1704293964,42,COMPLETED
5314648,1,1,1704293919,1704293922,1704293968,46,COMPLETED
5314649,1,1,1704293919,1704293922,1704293964,42,COMPLETED
5314650,1,1,1704293919,1704293922,1704293969,47,COMPLETED
5314651,1,1,1704293919,1704293922,1704293962,40,COMPLETED
5314652,1,1,1704293919,1704293922,1704293964,42,COMPLETED
5314653,1,1,1704293919,1704293922,1704293966,44,COMPLETED
5314654,1,1,1704293919,1704293922,1704293968,46,COMPLETED
5314655,1,1,1704293919,1704293922,1704293969,47,COMPLETED
5314656,1,1,1704293919,1704293922,1704293962,40,COMPLETED
5314657,1,1,1704293920,1704293922,1704293962,40,COMPLETED
5314658,1,1,1704293920,1704293922,1704293968,46,COMPLETED
5314659,1,1,1704293920,1704293922,1704293962,40,COMPLETED
5314660,1,1,1704293920,1704293922,1704293968,46,COMPLETED
5314661,1,1,1704293920,1704293922,1704293965,43,COMPLETED
5314662,1,1,1704293920,1704293922,1704293962,40,COMPLETED
5314663,1,1,1704293920,1704293922,1704293964,42,COMPLETED
5314664,1,1,1704293920,1704293922,1704293961,39,COMPLETED
5314665,1,1,1704293920,1704293922,1704293961,39,COMPLETED
5314666,1,1,1704293920,1704293922,1704293961,39,COMPLETED
5314667,1,1,1704293920,1704293922,1704293961,39,COMPLETED
5314668,1,1,1704293920,1704293922,1704293962,40,COMPLETED
5314669,1,1,1704293920,1704293922,1704293961,39,COMPLETED
5314670,1,1,1704293920,1704293922,1704293961,39,COMPLETED
5314671,1,1,1704293921,1704293922,1704293961,39,COMPLETED
5314672,1,1,1704293921,1704293922,1704293961,39,COMPLETED
5314673,1,1,1704293921,1704293922,1704293961,39,COMPLETED
5314674,1,1,1704293921,1704293922,1704293961,39,COMPLETED
5314675,1,1,1704293921,1704293922,1704293961,39,COMPLETED
5314676,1,1,1704293921,1704293922,1704293961,39,COMPLETED
5314677,1,1,1704294022,1704294025,1704294083,58,COMPLETED
5314678,1,1,1704294022,1704294025,1704294085,60,COMPLETED
5314679,1,1,1704294022,1704294025,1704294081,56,COMPLETED
5314680,1,1,1704294022,1704294025,1704294081,56,COMPLETED
5314681,1,1,1704294022,1704294025,1704294084,59,COMPLETED
5314682,1,1,1704294022,1704294025,1704294086,61,COMPLETED
5314683,1,1,1704294022,1704294025,1704294084,59,COMPLETED
5314684,1,1,1704294022,1704294025,1704294085,60,COMPLETED
5314685,1,1,1704294023,1704294025,1704294081,56,COMPLETED
5314686,1,1,1704294023,1704294025,1704294086,61,COMPLETED
5314687,1,1,1704294023,1704294025,1704294083,58,COMPLETED
5314688,1,1,1704294023,1704294025,1704294086,61,COMPLETED
5314689,1,1,1704294023,1704294025,1704294085,60,COMPLETED
5314690,1,1,1704294023,1704294025,1704294085,60,COMPLETED
5314691,1,1,1704294023,1704294025,1704294083,58,COMPLETED
5314692,1,1,1704294023,1704294026,1704294086,60,COMPLETED
5314693,1,1,1704294023,1704294026,1704294082,56,COMPLETED
5314694,1,1,1704294023,1704294026,1704294086,60,COMPLETED
5314695,1,1,1704294023,1704294026,1704294081,55,COMPLETED
5314696,1,1,1704294023,1704294026,1704294081,55,COMPLETED
5314697,1,1,1704294023,1704294026,1704294090,64,COMPLETED
5314698,1,1,1704294023,1704294026,1704294085,59,COMPLETED
5314699,1,1,1704294023,1704294026,1704294083,57,COMPLETED
5314700,1,1,1704294023,1704294026,1704294093,67,COMPLETED
5314701,1,1,1704294023,1704294026,1704294082,56,COMPLETED
5314702,1,1,1704294023,1704294026,1704294081,55,COMPLETED
5314703,1,1,1704294023,1704294026,1704294094,68,COMPLETED
5314704,1,1,1704294023,1704294026,1704294081,55,COMPLETED
5314705,1,1,1704294023,1704294026,1704294084,58,COMPLETED
5314706,1,1,1704294024,1704294026,1704294086,60,COMPLETED
5314707,1,1,1704294024,1704294026,1704294082,56,COMPLETED
5314708,1,1,1704294024,1704294026,1704294081,55,COMPLETED
5314709,1,1,1704294024,1704294026,1704294082,56,COMPLETED
5314710,1,1,1704294024,1704294026,1704294085,59,COMPLETED
5314711,1,1,1704294024,1704294026,1704294083,57,COMPLETED
5314712,1,1,1704294024,1704294026,1704294082,56,COMPLETED
5314713,1,1,1704294024,1704294026,1704294095,69,COMPLETED
5314714,1,1,1704294024,1704294026,1704294081,55,COMPLETED
5314715,1,1,1704294024,1704294026,1704294082,56,COMPLETED
5314716,1,1,1704294024,1704294026,1704294092,66,COMPLETED
5314717,1,1,1704294024,1704294026,1704294081,55,COMPLETED
5314718,1,1,1704294024,1704294026,1704294082,56,COMPLETED
5314719,1,1,1704294024,1704294026,1704294085,59,COMPLETED
5314720,1,1,1704294024,1704294026,1704294085,59,COMPLETED
5314721,1,1,1704294024,1704294026,1704294083,57,COMPLETED
5314722,1,1,1704294025,1704294026,1704294085,59,COMPLETED
5314723,1,1,1704294025,1704294026,1704294086,60,COMPLETED
5314724,1,1,1704294025,1704294026,1704294085,59,COMPLETED
5314725,1,1,1704294025,1704294026,1704294082,56,COMPLETED
5314726,1,1,1704294025,1704294026,1704294083,57,COMPLETED
5314727,1,1,1704294025,1704294026,1704294085,59,COMPLETED
5314728,1,1,1704294025,1704294026,1704294085,59,COMPLETED
5314729,1,1,1704294025,1704294026,1704294081,55,COMPLETED
5314730,1,1,1704294025,1704294026,1704294081,55,COMPLETED
5314731,1,1,1704294025,1704294026,1704294082,56,COMPLETED
5314732,1,1,1704294025,1704294026,1704294083,57,COMPLETED
5314733,1,1,1704294025,1704294026,1704294083,57,COMPLETED
5314734,1,1,1704294025,1704294026,1704294096,70,COMPLETED
5314735,1,1,1704294025,1704294026,1704294086,60,COMPLETED
5314736,1,1,1704294025,1704294026,1704294082,56,COMPLETED
5314737,1,1,1704294025,1704294026,1704294092,66,COMPLETED
5314738,1,1,1704294025,1704294026,1704294088,62,COMPLETED
5314739,1,1,1704294025,1704294026,1704294085,59,COMPLETED
5314740,1,1,1704294025,1704294026,1704294082,56,COMPLETED
5314741,1,1,1704294025,1704294026,1704294082,56,COMPLETED
5314742,1,1,1704294026,1704294029,1704294083,54,COMPLETED
5314743,1,1,1704294026,1704294029,1704294084,55,COMPLETED
5314744,1,1,1704294026,1704294029,1704294081,52,COMPLETED
5314745,1,1,1704294026,1704294029,1704294081,52,COMPLETED
5314746,1,1,1704294026,1704294029,1704294085,56,COMPLETED
5314747,1,1,1704294026,1704294029,1704294081,52,COMPLETED
5314748,1,1,1704294026,1704294030,1704294083,53,COMPLETED
5314749,1,1,1704294026,1704294030,1704294083,53,COMPLETED
5314750,1,1,1704294026,1704294030,1704294082,52,COMPLETED
5314751,1,1,1704294026,1704294030,1704294081,51,COMPLETED
5314752,1,1,1704294026,1704294030,1704294081,51,COMPLETED
5314753,1,1,1704294026,1704294030,1704294081,51,COMPLETED
5314754,1,1,1704294026,1704294030,1704294081,51,COMPLETED
5314755,1,1,1704294026,1704294030,1704294083,53,COMPLETED
5314756,1,1,1704294026,1704294030,1704294094,64,COMPLETED
5314757,1,1,1704294026,1704294030,1704294082,52,COMPLETED
5314758,1,1,1704294027,1704294030,1704294090,60,COMPLETED
5314759,1,1,1704294027,1704294030,1704294081,51,COMPLETED
5314760,1,1,1704294027,1704294030,1704294084,54,COMPLETED
5314761,1,1,1704294027,1704294030,1704294081,51,COMPLETED
5314762,1,1,1704294027,1704294030,1704294085,55,COMPLETED
5314763,1,1,1704294027,1704294030,1704294090,60,COMPLETED
5314764,1,1,1704294027,1704294030,1704294082,52,COMPLETED
5314765,1,1,1704294027,1704294030,1704294086,56,COMPLETED
5314766,1,1,1704294027,1704294030,1704294096,66,COMPLETED
5314767,1,1,1704294027,1704294030,1704294081,51,COMPLETED
5314768,1,1,1704294027,1704294030,1704294082,52,COMPLETED
5314769,1,1,1704294027,1704294030,1704294096,66,COMPLETED
5314770,1,1,1704294027,1704294030,1704294095,65,COMPLETED
5314771,1,1,1704294027,1704294030,1704294081,51,COMPLETED
5314772,1,1,1704294027,1704294030,1704294082,52,COMPLETED
5314773,1,1,1704294027,1704294030,1704294081,51,COMPLETED
5314774,1,1,1704294027,1704294030,1704294083,53,COMPLETED
5314775,1,1,1704294027,1704294030,1704294093,63,COMPLETED
5314776,1,1,1704294027,1704294030,1704294081,51,COMPLETED
5314777,1,1,1704294027,1704294030,1704294082,52,COMPLETED
5314778,1,1,1704294027,1704294030,1704294081,51,COMPLETED
5314779,1,1,1704294027,1704294030,1704294084,54,COMPLETED
5314780,1,1,1704294027,1704294030,1704294084,54,COMPLETED
5314781,1,1,1704294027,1704294030,1704294081,51,COMPLETED
5314782,1,1,1704294027,1704294030,1704294082,52,COMPLETED
5314783,1,1,1704294028,1704294030,1704294085,55,COMPLETED
5314784,1,1,1704294028,1704294030,1704294086,56,COMPLETED
5314785,1,1,1704294028,1704294030,1704294087,57,COMPLETED
5314786,1,1,1704294028,1704294030,1704294083,53,COMPLETED
5314787,1,1,1704294028,1704294030,1704294081,51,COMPLETED
5314788,1,1,1704294028,1704294030,1704294083,53,COMPLETED
5314789,1,1,1704294028,1704294030,1704294086,56,COMPLETED
5314790,1,1,1704294028,1704294030,1704294085,55,COMPLETED
5314791,1,1,1704294028,1704294030,1704294083,53,COMPLETED
5314792,1,1,1704294028,1704294030,1704294083,53,COMPLETED
5314793,1,1,1704294028,1704294030,1704294086,56,COMPLETED
5314794,1,1,1704294028,1704294030,1704294086,56,COMPLETED
5314795,1,1,1704294028,1704294030,1704294081,51,COMPLETED
5314796,1,1,1704294028,1704294030,1704294087,57,COMPLETED
5314797,1,1,1704294028,1704294030,1704294095,65,COMPLETED
5314798,1,1,1704294028,1704294030,1704294085,55,COMPLETED
5314799,1,1,1704294028,1704294030,1704294081,51,COMPLETED
5314800,1,1,1704294028,1704294030,1704294094,64,COMPLETED
5314801,1,1,1704294028,1704294030,1704294085,55,COMPLETED
5314802,1,1,1704294028,1704294030,1704294085,55,COMPLETED
5314803,1,1,1704294028,1704294030,1704294086,56,COMPLETED
5314804,1,1,1704294028,1704294030,1704294083,53,COMPLETED
5314805,1,1,1704294028,1704294030,1704294086,56,COMPLETED
5314806,1,1,1704294028,1704294030,1704294086,56,COMPLETED
5314807,1,1,1704294028,1704294030,1704294081,51,COMPLETED
5314808,1,1,1704294028,1704294030,1704294081,51,COMPLETED
5314809,1,1,1704294029,1704294030,1704294085,55,COMPLETED
5314810,1,1,1704294029,1704294030,1704294081,51,COMPLETED
5314811,1,1,1704294029,1704294030,1704294094,64,COMPLETED
5314812,1,1,1704294029,1704294030,1704294085,55,COMPLETED
5314813,1,1,1704294029,1704294030,1704294085,55,COMPLETED
5314814,1,1,1704294029,1704294030,1704294086,56,COMPLETED
5314815,1,1,1704294029,1704294030,1704294085,55,COMPLETED
5314816,1,1,1704294029,1704294030,1704294087,57,COMPLETED
5314817,1,1,1704294029,1704294030,1704294081,51,COMPLETED
5314818,1,1,1704294029,1704294030,1704294087,57,COMPLETED
5314819,1,1,1704294029,1704294030,1704294091,61,COMPLETED
5314820,1,1,1704294029,1704294030,1704294081,51,COMPLETED
5314821,1,1,1704294029,1704294030,1704294085,55,COMPLETED
5314822,1,1,1704294029,1704294030,1704294088,58,COMPLETED
5314823,1,1,1704294029,1704294030,1704294081,51,COMPLETED
5314824,1,1,1704294029,1704294030,1704294087,57,COMPLETED
5314825,1,1,1704294029,1704294030,1704294088,58,COMPLETED
5314826,1,1,1704294029,1704294030,1704294086,56,COMPLETED
5314827,1,1,1704294029,1704294030,1704294088,58,COMPLETED
5314828,1,1,1704294029,1704294030,1704294087,57,COMPLETED
5314829,1,1,1704294029,1704294030,1704294090,60,COMPLETED
5314830,1,1,1704294029,1704294030,1704294088,58,COMPLETED
5314831,1,1,1704294029,1704294030,1704294087,57,COMPLETED
5314832,1,1,1704294029,1704294030,1704294086,56,COMPLETED
5314833,1,1,1704294029,1704294030,1704294086,56,COMPLETED
5314834,1,1,1704294029,1704294030,1704294083,53,COMPLETED
5314835,1,1,1704294030,1704294034,1704294087,53,COMPLETED
5314836,1,1,1704294030,1704294034,1704294087,53,COMPLETED
5314837,1,1,1704294030,1704294034,1704294086,52,COMPLETED
5314838,1,1,1704294030,1704294034,1704294088,54,COMPLETED
5314839,1,1,1704294030,1704294034,1704294086,52,COMPLETED
5314840,1,1,1704294030,1704294034,1704294086,52,COMPLETED
5314841,1,1,1704294030,1704294034,1704294085,51,COMPLETED
5314842,1,1,1704294030,1704294034,1704294085,51,COMPLETED
5314843,1,1,1704294030,1704294034,1704294084,50,COMPLETED
5314844,1,1,1704294030,1704294034,1704294088,54,COMPLETED
5314845,1,1,1704294030,1704294034,1704294082,48,COMPLETED
5314846,1,1,1704294030,1704294034,1704294081,47,COMPLETED
5314847,1,1,1704294030,1704294034,1704294081,47,COMPLETED
5314848,1,1,1704294030,1704294034,1704294086,52,COMPLETED
5314849,1,1,1704294030,1704294034,1704294081,47,COMPLETED
5314850,1,1,1704294030,1704294034,1704294087,53,COMPLETED
5314851,1,1,1704294031,1704294034,1704294088,54,COMPLETED
5314852,1,1,1704294031,1704294034,1704294086,52,COMPLETED
5314853,1,1,1704294031,1704294034,1704294083,49,COMPLETED
5314854,1,1,1704294031,1704294034,1704294095,61,COMPLETED
5314855,1,1,1704294031,1704294034,1704294081,47,COMPLETED
5314856,1,1,1704294031,1704294034,1704294081,47,COMPLETED
5314857,1,1,1704294031,1704294034,1704294081,47,COMPLETED
5314858,1,1,1704294031,1704294034,1704294082,48,COMPLETED
5314859,1,1,1704294031,1704294034,1704294081,47,COMPLETED
5314860,1,1,1704294031,1704294034,1704294082,48,COMPLETED
5314861,1,1,1704294031,1704294034,1704294081,47,COMPLETED
5314862,1,1,1704294031,1704294034,1704294081,47,COMPLETED
5314863,1,1,1704294031,1704294034,1704294081,47,COMPLETED
5314864,1,1,1704294031,1704294034,1704294081,47,COMPLETED
5314865,1,1,1704294031,1704294034,1704294081,47,COMPLETED
5314866,1,1,1704294031,1704294034,1704294081,47,COMPLETED
5314867,1,1,1704294031,1704294034,1704294085,51,COMPLETED
5314868,1,1,1704294031,1704294034,1704294081,47,COMPLETED
5314869,1,1,1704294031,1704294034,1704294094,60,COMPLETED
5314870,1,1,1704294031,1704294034,1704294081,47,COMPLETED
5314871,1,1,1704294031,1704294034,1704294081,47,COMPLETED
5314872,1,1,1704294032,1704294034,1704294081,47,COMPLETED
5314873,1,1,1704294032,1704294034,1704294097,63,COMPLETED
5314874,1,1,1704294032,1704294034,1704294081,47,COMPLETED
5314875,1,1,1704294032,1704294034,1704294081,47,COMPLETED
5314876,1,1,1704294032,1704294034,1704294081,47,COMPLETED
5314877,1,1,1704294084,1704294084,1704294133,49,COMPLETED
5314878,1,1,1704294085,1704294085,1704294135,50,COMPLETED
5314879,1,1,1704294085,1704294085,1704294135,50,COMPLETED
5314880,1,1,1704294085,1704294085,1704294131,46,COMPLETED
5314881,1,1,1704294085,1704294085,1704294131,46,COMPLETED
5314882,1,1,1704294085,1704294085,1704294131,46,COMPLETED
5314883,1,1,1704294086,1704294086,1704294131,45,COMPLETED
5314884,1,1,1704294086,1704294086,1704294131,45,COMPLETED
5314885,1,1,1704294086,1704294086,1704294131,45,COMPLETED
5314886,1,1,1704294086,1704294086,1704294131,45,COMPLETED
5314887,1,1,1704294086,1704294086,1704294131,45,COMPLETED
5314888,1,1,1704294086,1704294086,1704294131,45,COMPLETED
5314889,1,1,1704294086,1704294086,1704294132,46,COMPLETED
5314890,1,1,1704294086,1704294086,1704294135,49,COMPLETED
5314891,1,1,1704294087,1704294087,1704294132,45,COMPLETED
5314892,1,1,1704294087,1704294087,1704294134,47,COMPLETED
5314893,1,1,1704294087,1704294087,1704294134,47,COMPLETED
5314894,1,1,1704294087,1704294087,1704294134,47,COMPLETED
5314895,1,1,1704294087,1704294087,1704294133,46,COMPLETED
5314896,1,1,1704294087,1704294087,1704294133,46,COMPLETED
5314897,1,1,1704294087,1704294087,1704294133,46,COMPLETED
5314898,1,1,1704294087,1704294087,1704294136,49,COMPLETED
5314899,1,1,1704294087,1704294087,1704294132,45,COMPLETED
5314900,1,1,1704294087,1704294087,1704294136,49,COMPLETED
5314901,1,1,1704294088,1704294088,1704294133,45,COMPLETED
5314902,1,1,1704294088,1704294088,1704294135,47,COMPLETED
5314903,1,1,1704294088,1704294088,1704294132,44,COMPLETED
5314904,1,1,1704294088,1704294088,1704294142,54,COMPLETED
5314905,1,1,1704294088,1704294088,1704294135,47,COMPLETED
5314906,1,1,1704294088,1704294088,1704294133,45,COMPLETED
5314907,1,1,1704294088,1704294088,1704294134,46,COMPLETED
5314908,1,1,1704294088,1704294088,1704294134,46,COMPLETED
5314909,1,1,1704294088,1704294088,1704294134,46,COMPLETED
5314910,1,1,1704294089,1704294089,1704294132,43,COMPLETED
5314911,1,1,1704294089,1704294089,1704294133,44,COMPLETED
5314912,1,1,1704294089,1704294089,1704294133,44,COMPLETED
5314913,1,1,1704294089,1704294089,1704294132,43,COMPLETED
5314914,1,1,1704294089,1704294089,1704294131,42,COMPLETED
5314915,1,1,1704294089,1704294089,1704294134,45,COMPLETED
5314916,1,1,1704294089,1704294089,1704294131,42,COMPLETED
5314917,1,1,1704294089,1704294090,1704294131,41,COMPLETED
5314918,1,1,1704294089,1704294090,1704294131,41,COMPLETED
5314919,1,1,1704294089,1704294090,1704294131,41,COMPLETED
5314920,1,1,1704294090,1704294091,1704294133,42,COMPLETED
5314921,1,1,1704294090,1704294091,1704294135,44,COMPLETED
5314922,1,1,1704294090,1704294091,1704294133,42,COMPLETED
5314923,1,1,1704294090,1704294091,1704294132,41,COMPLETED
5314924,1,1,1704294090,1704294091,1704294131,40,COMPLETED
5314925,1,1,1704294090,1704294091,1704294131,40,COMPLETED
5314926,1,1,1704294090,1704294091,1704294133,42,COMPLETED
5314927,1,1,1704294090,1704294091,1704294131,40,COMPLETED
5314928,1,1,1704294091,1704294091,1704294131,40,COMPLETED
5314929,1,1,1704294091,1704294091,1704294131,40,COMPLETED
5314930,1,1,1704294091,1704294091,1704294131,40,COMPLETED
5314931,1,1,1704294091,1704294091,1704294131,40,COMPLETED
5314932,1,1,1704294091,1704294091,1704294131,40,COMPLETED
5314933,1,1,1704294091,1704294092,1704294131,39,COMPLETED
5314934,1,1,1704294091,1704294092,1704294131,39,COMPLETED
5314935,1,1,1704294091,1704294092,1704294131,39,COMPLETED
5314936,1,1,1704294091,1704294092,1704294131,39,COMPLETED
5314937,1,1,1704294092,1704294092,1704294132,40,COMPLETED
5314938,1,1,1704294092,1704294092,1704294131,39,COMPLETED
5314939,1,1,1704294092,1704294093,1704294131,38,COMPLETED
5314940,1,1,1704294092,1704294093,1704294131,38,COMPLETED
5314941,1,1,1704294092,1704294093,1704294131,38,COMPLETED
5314942,1,1,1704294092,1704294093,1704294131,38,COMPLETED
5314943,1,1,1704294092,1704294093,1704294131,38,COMPLETED
5314944,1,1,1704294092,1704294093,1704294131,38,COMPLETED
5314945,1,1,1704294093,1704294093,1704294131,38,COMPLETED
5314946,1,1,1704294093,1704294093,1704294131,38,COMPLETED
5314947,1,1,1704294093,1704294094,1704294131,37,COMPLETED
5314948,1,1,1704294093,1704294094,1704294131,37,COMPLETED
5314949,1,1,1704294093,1704294094,1704294131,37,COMPLETED
5314950,1,1,1704294093,1704294094,1704294131,37,COMPLETED
5314951,1,1,1704294093,1704294094,1704294131,37,COMPLETED
5314952,1,1,1704294093,1704294094,1704294131,37,COMPLETED
5314953,1,1,1704294093,1704294094,1704294131,37,COMPLETED
5314954,1,1,1704294093,1704294094,1704294131,37,COMPLETED
5314955,1,1,1704294094,1704294094,1704294131,37,COMPLETED
5314956,1,1,1704294094,1704294095,1704294132,37,COMPLETED
5314957,1,1,1704294094,1704294095,1704294131,36,COMPLETED
5314958,1,1,1704294094,1704294095,1704294131,36,COMPLETED
5314959,1,1,1704294094,1704294095,1704294133,38,COMPLETED
5314960,1,1,1704294094,1704294095,1704294131,36,COMPLETED
5314961,1,1,1704294094,1704294095,1704294131,36,COMPLETED
5314962,1,1,1704294094,1704294095,1704294131,36,COMPLETED
5314963,1,1,1704294094,1704294095,1704294132,37,COMPLETED
5314964,1,1,1704294095,1704294095,1704294131,36,COMPLETED
5314965,1,1,1704294095,1704294095,1704294131,36,COMPLETED
5314966,1,1,1704294095,1704294095,1704294131,36,COMPLETED
5314967,1,1,1704294095,1704294096,1704294133,37,COMPLETED
5314968,1,1,1704294095,1704294096,1704294132,36,COMPLETED
5314969,1,1,1704294095,1704294096,1704294131,35,COMPLETED
5314970,1,1,1704294096,1704294096,1704294178,82,COMPLETED
5314971,1,1,1704294096,1704294096,1704294131,35,COMPLETED
5314972,1,1,1704294096,1704294096,1704294132,36,COMPLETED
5314973,1,1,1704294096,1704294096,1704294131,35,COMPLETED
5314974,1,1,1704294096,1704294096,1704294134,38,COMPLETED
5314975,1,1,1704294096,1704294097,1704294131,34,COMPLETED
5314976,1,1,1704294096,1704294097,1704294131,34,COMPLETED
5314977,1,1,1704294096,1704294097,1704294131,34,COMPLETED
5314978,1,1,1704294096,1704294097,1704294131,34,COMPLETED
5314979,1,1,1704294097,1704294097,1704294133,36,COMPLETED
5314980,1,1,1704294097,1704294097,1704294132,35,COMPLETED
5314981,1,1,1704294097,1704294097,1704294131,34,COMPLETED
5314982,1,1,1704294097,1704294097,1704294131,34,COMPLETED
5314983,1,1,1704294097,1704294097,1704294132,35,COMPLETED
5314984,1,1,1704294097,1704294097,1704294131,34,COMPLETED
5314985,1,1,1704294097,1704294097,1704294131,34,COMPLETED
5314986,1,1,1704294097,1704294098,1704294131,33,COMPLETED
5314987,1,1,1704294097,1704294098,1704294135,37,COMPLETED
5314988,1,1,1704294097,1704294098,1704294131,33,COMPLETED
5314989,1,1,1704294097,1704294098,1704294131,33,COMPLETED
5314990,1,1,1704294097,1704294098,1704294132,34,COMPLETED
5314991,1,1,1704294097,1704294098,1704294131,33,COMPLETED
5314992,1,1,1704294098,1704294098,1704294131,33,COMPLETED
5314993,1,1,1704294098,1704294098,1704294133,35,COMPLETED
5314994,1,1,1704294202,1704294205,1704294260,55,COMPLETED
5314995,1,1,1704294202,1704294205,1704294260,55,COMPLETED
5314996,1,1,1704294202,1704294205,1704294262,57,COMPLETED
5314997,1,1,1704294202,1704294205,1704294274,69,COMPLETED
5314998,1,1,1704294202,1704294205,1704294260,55,COMPLETED
5314999,1,1,1704294202,1704294205,1704294262,57,COMPLETED
5315000,1,1,1704294202,1704294205,1704294261,56,COMPLETED
5315001,1,1,1704294202,1704294205,1704294264,59,COMPLETED
5315002,1,1,1704294202,1704294205,1704294261,56,COMPLETED
5315003,1,1,1704294202,1704294205,1704294260,55,COMPLETED
5315004,1,1,1704294202,1704294205,1704294264,59,COMPLETED
5315005,1,1,1704294202,1704294205,1704294260,55,COMPLETED
5315006,1,1,1704294202,1704294205,1704294263,58,COMPLETED
5315007,1,1,1704294202,1704294205,1704294260,55,COMPLETED
5315008,1,1,1704294202,1704294205,1704294270,65,COMPLETED
5315009,1,1,1704294202,1704294205,1704294261,56,COMPLETED
5315010,1,1,1704294202,1704294205,1704294262,57,COMPLETED
5315011,1,1,1704294203,1704294205,1704294266,61,COMPLETED
5315012,1,1,1704294203,1704294205,1704294270,65,COMPLETED
5315013,1,1,1704294203,1704294205,1704294266,61,COMPLETED
5315014,1,1,1704294203,1704294205,1704294263,58,COMPLETED
5315015,1,1,1704294203,1704294205,1704294260,55,COMPLETED
5315016,1,1,1704294203,1704294205,1704294260,55,COMPLETED
5315017,1,1,1704294203,1704294205,1704294260,55,COMPLETED
5315018,1,1,1704294203,1704294205,1704294263,58,COMPLETED
5315019,1,1,1704294203,1704294205,1704294270,65,COMPLETED
5315020,1,1,1704294203,1704294205,1704294263,58,COMPLETED
5315021,1,1,1704294203,1704294205,1704294260,55,COMPLETED
5315022,1,1,1704294203,1704294205,1704294263,58,COMPLETED
5315023,1,1,1704294203,1704294205,1704294264,59,COMPLETED
5315024,1,1,1704294203,1704294205,1704294264,59,COMPLETED
5315025,1,1,1704294203,1704294205,1704294260,55,COMPLETED
5315026,1,1,1704294203,1704294205,1704294260,55,COMPLETED
5315027,1,1,1704294203,1704294205,1704294260,55,COMPLETED
5315028,1,1,1704294203,1704294205,1704294260,55,COMPLETED
5315029,1,1,1704294203,1704294205,1704294262,57,COMPLETED
5315030,1,1,1704294203,1704294205,1704294260,55,COMPLETED
5315031,1,1,1704294203,1704294205,1704294270,65,COMPLETED
5315032,1,1,1704294203,1704294205,1704294264,59,COMPLETED
5315033,1,1,1704294203,1704294205,1704294260,55,COMPLETED
5315034,1,1,1704294203,1704294205,1704294266,61,COMPLETED
5315035,1,1,1704294203,1704294205,1704294266,61,COMPLETED
5315036,1,1,1704294203,1704294205,1704294269,64,COMPLETED
5315037,1,1,1704294203,1704294205,1704294260,55,COMPLETED
5315038,1,1,1704294203,1704294205,1704294270,65,COMPLETED
5315039,1,1,1704294203,1704294205,1704294260,55,COMPLETED
5315040,1,1,1704294203,1704294205,1704294262,57,COMPLETED
5315041,1,1,1704294203,1704294205,1704294260,55,COMPLETED
5315042,1,1,1704294203,1704294205,1704294262,57,COMPLETED
5315043,1,1,1704294204,1704294205,1704294262,57,COMPLETED
5315044,1,1,1704294204,1704294205,1704294260,55,COMPLETED
5315045,1,1,1704294204,1704294205,1704294260,55,COMPLETED
5315046,1,1,1704294204,1704294205,1704294267,62,COMPLETED
5315047,1,1,1704294204,1704294205,1704294260,55,COMPLETED
5315048,1,1,1704294204,1704294205,1704294266,61,COMPLETED
5315049,1,1,1704294204,1704294205,1704294271,66,COMPLETED
5315050,1,1,1704294204,1704294205,1704294260,55,COMPLETED
5315051,1,1,1704294204,1704294205,1704294262,57,COMPLETED
5315052,1,1,1704294204,1704294205,1704294270,65,COMPLETED
5315053,1,1,1704294204,1704294205,1704294262,57,COMPLETED
5315054,1,1,1704294204,1704294205,1704294260,55,COMPLETED
5315055,1,1,1704294204,1704294205,1704294266,61,COMPLETED
5315056,1,1,1704294204,1704294205,1704294260,55,COMPLETED
5315057,1,1,1704294204,1704294205,1704294260,55,COMPLETED
5315058,1,1,1704294204,1704294205,1704294266,61,COMPLETED
5315059,1,1,1704294204,1704294205,1704294269,64,COMPLETED
5315060,1,1,1704294204,1704294205,1704294260,55,COMPLETED
5315061,1,1,1704294204,1704294205,1704294264,59,COMPLETED
5315062,1,1,1704294204,1704294205,1704294260,55,COMPLETED
5315063,1,1,1704294204,1704294205,1704294260,55,COMPLETED
5315064,1,1,1704294204,1704294205,1704294260,55,COMPLETED
5315065,1,1,1704294204,1704294205,1704294263,58,COMPLETED
5315066,1,1,1704294204,1704294205,1704294266,61,COMPLETED
5315067,1,1,1704294204,1704294205,1704294266,61,COMPLETED
5315068,1,1,1704294204,1704294205,1704294260,55,COMPLETED
5315069,1,1,1704294204,1704294205,1704294263,58,COMPLETED
5315070,1,1,1704294204,1704294205,1704294266,61,COMPLETED
5315071,1,1,1704294205,1704294205,1704294260,55,COMPLETED
5315072,1,1,1704294205,1704294205,1704294269,64,COMPLETED
5315073,1,1,1704294205,1704294205,1704294263,58,COMPLETED
5315074,1,1,1704294205,1704294205,1704294266,61,COMPLETED
5315075,1,1,1704294205,1704294205,1704294263,58,COMPLETED
5315076,1,1,1704294205,1704294205,1704294263,58,COMPLETED
5315077,1,1,1704294205,1704294205,1704294263,58,COMPLETED
5315078,1,1,1704294205,1704294205,1704294266,61,COMPLETED
5315079,1,1,1704294205,1704294205,1704294266,61,COMPLETED
5315080,1,1,1704294205,1704294205,1704294260,55,COMPLETED
5315081,1,1,1704294205,1704294205,1704294260,55,COMPLETED
5315082,1,1,1704294205,1704294205,1704294260,55,COMPLETED
5315083,1,1,1704294205,1704294205,1704294266,61,COMPLETED
5315084,1,1,1704294205,1704294205,1704294263,58,COMPLETED
5315085,1,1,1704294205,1704294205,1704294266,61,COMPLETED
5315086,1,1,1704294205,1704294205,1704294266,61,COMPLETED
5315087,1,1,1704294205,1704294205,1704294264,59,COMPLETED
5315088,1,1,1704294205,1704294205,1704294266,61,COMPLETED
5315089,1,1,1704294205,1704294205,1704294260,55,COMPLETED
5315090,1,1,1704294205,1704294205,1704294260,55,COMPLETED
5315091,1,1,1704294205,1704294209,1704294261,52,COMPLETED
5315092,1,1,1704294205,1704294209,1704294260,51,COMPLETED
5315093,1,1,1704294205,1704294209,1704294263,54,COMPLETED
5315094,1,1,1704294206,1704294209,1704294263,54,COMPLETED
5315095,1,1,1704294206,1704294209,1704294260,51,COMPLETED
5315096,1,1,1704294206,1704294209,1704294266,57,COMPLETED
5315097,1,1,1704294206,1704294209,1704294271,62,COMPLETED
5315098,1,1,1704294206,1704294209,1704294263,54,COMPLETED
5315099,1,1,1704294206,1704294209,1704294263,54,COMPLETED
5315100,1,1,1704294206,1704294209,1704294263,54,COMPLETED
5315101,1,1,1704294206,1704294209,1704294272,63,COMPLETED
5315102,1,1,1704294206,1704294209,1704294261,52,COMPLETED
5315103,1,1,1704294206,1704294209,1704294260,51,COMPLETED
5315104,1,1,1704294206,1704294209,1704294261,52,COMPLETED
5315105,1,1,1704294206,1704294209,1704294261,52,COMPLETED
5315106,1,1,1704294206,1704294209,1704294260,51,COMPLETED
5315107,1,1,1704294206,1704294209,1704294263,54,COMPLETED
5315108,1,1,1704294206,1704294209,1704294262,53,COMPLETED
5315109,1,1,1704294206,1704294209,1704294260,51,COMPLETED
5315110,1,1,1704294206,1704294209,1704294260,51,COMPLETED
5315111,1,1,1704294206,1704294209,1704294266,57,COMPLETED
5315112,1,1,1704294206,1704294209,1704294261,52,COMPLETED
5315113,1,1,1704294206,1704294209,1704294272,63,COMPLETED
5315114,1,1,1704294206,1704294209,1704294263,54,COMPLETED
5315115,1,1,1704294206,1704294209,1704294260,51,COMPLETED
5315116,1,1,1704294207,1704294209,1704294263,54,COMPLETED
5315117,1,1,1704294207,1704294209,1704294271,62,COMPLETED
5315118,1,1,1704294207,1704294209,1704294260,51,COMPLETED
5315119,1,1,1704294207,1704294209,1704294260,51,COMPLETED
5315120,1,1,1704294207,1704294209,1704294269,60,COMPLETED
5315121,1,1,1704294207,1704294209,1704294260,51,COMPLETED
5315122,1,1,1704294207,1704294209,1704294260,51,COMPLETED
5315123,1,1,1704294207,1704294209,1704294260,51,COMPLETED
5315124,1,1,1704294207,1704294209,1704294262,53,COMPLETED
5315125,1,1,1704294207,1704294209,1704294266,57,COMPLETED
5315126,1,1,1704294207,1704294209,1704294264,55,COMPLETED
5315127,1,1,1704294207,1704294209,1704294270,61,COMPLETED
5315128,1,1,1704294207,1704294209,1704294263,54,COMPLETED
5315129,1,1,1704294207,1704294209,1704294260,51,COMPLETED
5315130,1,1,1704294207,1704294209,1704294260,51,COMPLETED
5315131,1,1,1704294207,1704294209,1704294271,62,COMPLETED
5315132,1,1,1704294208,1704294209,1704294272,63,COMPLETED
5315133,1,1,1704294208,1704294209,1704294262,53,COMPLETED
5315134,1,1,1704294208,1704294209,1704294262,53,COMPLETED
5315135,1,1,1704294208,1704294209,1704294261,52,COMPLETED
5315136,1,1,1704294208,1704294209,1704294264,55,COMPLETED
5315137,1,1,1704294208,1704294209,1704294264,55,COMPLETED
5315138,1,1,1704294208,1704294209,1704294271,62,COMPLETED
5315139,1,1,1704294208,1704294209,1704294260,51,COMPLETED
5315140,1,1,1704294208,1704294209,1704294260,51,COMPLETED
5315141,1,1,1704294208,1704294209,1704294261,52,COMPLETED
5315142,1,1,1704294208,1704294209,1704294266,57,COMPLETED
5315143,1,1,1704294208,1704294209,1704294270,61,COMPLETED
5315144,1,1,1704294208,1704294209,1704294261,52,COMPLETED
5315145,1,1,1704294208,1704294209,1704294264,55,COMPLETED
5315146,1,1,1704294208,1704294209,1704294264,55,COMPLETED
5315147,1,1,1704294208,1704294209,1704294260,51,COMPLETED
5315148,1,1,1704294208,1704294209,1704294266,57,COMPLETED
5315149,1,1,1704294208,1704294209,1704294261,52,COMPLETED
5315150,1,1,1704294208,1704294209,1704294266,57,COMPLETED
5315151,1,1,1704294208,1704294209,1704294266,57,COMPLETED
5315152,1,1,1704294208,1704294209,1704294260,51,COMPLETED
5315153,1,1,1704294208,1704294209,1704294260,51,COMPLETED
5315154,1,1,1704294209,1704294209,1704294260,51,COMPLETED
5315155,1,1,1704294209,1704294209,1704294269,60,COMPLETED
5315156,1,1,1704294209,1704294209,1704294263,54,COMPLETED
5315157,1,1,1704294209,1704294209,1704294262,53,COMPLETED
5315158,1,1,1704294209,1704294209,1704294260,51,COMPLETED
5315159,1,1,1704294209,1704294209,1704294260,51,COMPLETED
5315160,1,1,1704294209,1704294209,1704294262,53,COMPLETED
5315162,1,1,1704294209,1704294209,1704294260,51,COMPLETED
5315163,1,1,1704294209,1704294209,1704294261,52,COMPLETED
5315164,1,1,1704294209,1704294209,1704294262,53,COMPLETED
5315165,1,1,1704294209,1704294209,1704294271,62,COMPLETED
5315166,1,1,1704294209,1704294209,1704294261,52,COMPLETED
5315167,1,1,1704294209,1704294209,1704294260,51,COMPLETED
5315168,1,1,1704294209,1704294209,1704294262,53,COMPLETED
5315169,1,1,1704294209,1704294209,1704294260,51,COMPLETED
5315170,1,1,1704294209,1704294209,1704294261,52,COMPLETED
5315171,1,1,1704294209,1704294209,1704294260,51,COMPLETED
5315172,1,1,1704294209,1704294209,1704294260,51,COMPLETED
5315173,1,1,1704294209,1704294209,1704294260,51,COMPLETED
5315174,1,1,1704294209,1704294209,1704294260,51,COMPLETED
5315175,1,1,1704294209,1704294213,1704294260,47,COMPLETED
5315176,1,1,1704294209,1704294213,1704294260,47,COMPLETED
5315177,1,1,1704294209,1704294213,1704294260,47,COMPLETED
5315161,1,1,1704294209,1704294209,1704294333,124,COMPLETED
5315178,1,1,1704294210,1704294213,1704294260,47,COMPLETED
5315179,1,1,1704294210,1704294213,1704294260,47,COMPLETED
5315180,1,1,1704294210,1704294213,1704294260,47,COMPLETED
5315181,1,1,1704294210,1704294213,1704294260,47,COMPLETED
5315182,1,1,1704294210,1704294213,1704294271,58,COMPLETED
5315183,1,1,1704294210,1704294213,1704294269,56,COMPLETED
5315184,1,1,1704294210,1704294213,1704294260,47,COMPLETED
5315185,1,1,1704294210,1704294213,1704294260,47,COMPLETED
5315186,1,1,1704294210,1704294213,1704294260,47,COMPLETED
5315187,1,1,1704294210,1704294213,1704294260,47,COMPLETED
5315188,1,1,1704294210,1704294213,1704294260,47,COMPLETED
5315189,1,1,1704294210,1704294213,1704294260,47,COMPLETED
5315190,1,1,1704294210,1704294213,1704294260,47,COMPLETED
5315191,1,1,1704294210,1704294213,1704294260,47,COMPLETED
5315192,1,1,1704294210,1704294213,1704294260,47,COMPLETED
5315193,1,1,1704294210,1704294213,1704294260,47,COMPLETED
5315194,1,1,1704294218,1704294218,1704294223,5,COMPLETED
5315196,1,1,1704294218,1704294237,1704294240,3,COMPLETED
5315198,1,1,1704294267,1704294267,1704294312,45,COMPLETED
5315199,1,1,1704294267,1704294267,1704294312,45,COMPLETED
5315200,1,1,1704294267,1704294267,1704294312,45,COMPLETED
5315201,1,1,1704294267,1704294267,1704294318,51,COMPLETED
5315202,1,1,1704294267,1704294267,1704294317,50,COMPLETED
5315203,1,1,1704294267,1704294267,1704294319,52,COMPLETED
5315204,1,1,1704294267,1704294267,1704294316,49,COMPLETED
5315205,1,1,1704294267,1704294267,1704294319,52,COMPLETED
5315206,1,1,1704294268,1704294268,1704294316,48,COMPLETED
5315207,1,1,1704294268,1704294269,1704294328,59,COMPLETED
5315208,1,1,1704294268,1704294269,1704294325,56,COMPLETED
5315209,1,1,1704294268,1704294269,1704294320,51,COMPLETED
5315210,1,1,1704294268,1704294269,1704294320,51,COMPLETED
5315211,1,1,1704294268,1704294269,1704294320,51,COMPLETED
5315212,1,1,1704294268,1704294269,1704294326,57,COMPLETED
5315213,1,1,1704294268,1704294269,1704294320,51,COMPLETED
5315214,1,1,1704294268,1704294269,1704294320,51,COMPLETED
5315215,1,1,1704294268,1704294269,1704294316,47,COMPLETED
5315216,1,1,1704294269,1704294269,1704294316,47,COMPLETED
5315217,1,1,1704294269,1704294269,1704294321,52,COMPLETED
5315218,1,1,1704294269,1704294269,1704294317,48,COMPLETED
5315219,1,1,1704294269,1704294269,1704294316,47,COMPLETED
5315220,1,1,1704294269,1704294269,1704294312,43,COMPLETED
5315221,1,1,1704294269,1704294269,1704294316,47,COMPLETED
5315222,1,1,1704294269,1704294269,1704294317,48,COMPLETED
5315223,1,1,1704294269,1704294269,1704294316,47,COMPLETED
5315224,1,1,1704294269,1704294269,1704294312,43,COMPLETED
5315225,1,1,1704294270,1704294270,1704294316,46,COMPLETED
5315226,1,1,1704294270,1704294270,1704294317,47,COMPLETED
5315227,1,1,1704294270,1704294270,1704294312,42,COMPLETED
5315228,1,1,1704294270,1704294270,1704294312,42,COMPLETED
5315229,1,1,1704294270,1704294270,1704294312,42,COMPLETED
5315230,1,1,1704294270,1704294270,1704294312,42,COMPLETED
5315231,1,1,1704294270,1704294270,1704294320,50,COMPLETED
5315232,1,1,1704294270,1704294270,1704294316,46,COMPLETED
5315233,1,1,1704294271,1704294271,1704294321,50,COMPLETED
5315234,1,1,1704294271,1704294271,1704294321,50,COMPLETED
5315235,1,1,1704294271,1704294271,1704294316,45,COMPLETED
5315236,1,1,1704294271,1704294271,1704294316,45,COMPLETED
5315237,1,1,1704294271,1704294271,1704294321,50,COMPLETED
5315238,1,1,1704294271,1704294271,1704294316,45,COMPLETED
5315239,1,1,1704294271,1704294271,1704294318,47,COMPLETED
5315240,1,1,1704294271,1704294271,1704294320,49,COMPLETED
5315241,1,1,1704294271,1704294271,1704294318,47,COMPLETED
5315242,1,1,1704294271,1704294271,1704294319,48,COMPLETED
5315243,1,1,1704294272,1704294272,1704294312,40,COMPLETED
5315244,1,1,1704294272,1704294272,1704294316,44,COMPLETED
5315245,1,1,1704294272,1704294272,1704294316,44,COMPLETED
5315246,1,1,1704294272,1704294272,1704294319,47,COMPLETED
5315247,1,1,1704294272,1704294272,1704294318,46,COMPLETED
5315248,1,1,1704294272,1704294272,1704294316,44,COMPLETED
5315249,1,1,1704294272,1704294272,1704294312,40,COMPLETED
5315250,1,1,1704294272,1704294272,1704294317,45,COMPLETED
5315251,1,1,1704294272,1704294272,1704294316,44,COMPLETED
5315252,1,1,1704294272,1704294272,1704294317,45,COMPLETED
5315253,1,1,1704294273,1704294273,1704294325,52,COMPLETED
5315254,1,1,1704294273,1704294273,1704294321,48,COMPLETED
5315255,1,1,1704294273,1704294273,1704294316,43,COMPLETED
5315256,1,1,1704294273,1704294273,1704294316,43,COMPLETED
5315257,1,1,1704294273,1704294273,1704294316,43,COMPLETED
5315258,1,1,1704294273,1704294273,1704294317,44,COMPLETED
5315259,1,1,1704294273,1704294273,1704294316,43,COMPLETED
5315260,1,1,1704294273,1704294273,1704294317,44,COMPLETED
5315261,1,1,1704294273,1704294273,1704294317,44,COMPLETED
5315262,1,1,1704294273,1704294273,1704294326,53,COMPLETED
5315263,1,1,1704294274,1704294275,1704294317,42,COMPLETED
5315264,1,1,1704294274,1704294275,1704294316,41,COMPLETED
5315265,1,1,1704294274,1704294275,1704294317,42,COMPLETED
5315266,1,1,1704294274,1704294275,1704294321,46,COMPLETED
5315267,1,1,1704294274,1704294275,1704294318,43,COMPLETED
5315268,1,1,1704294274,1704294275,1704294325,50,COMPLETED
5315269,1,1,1704294274,1704294275,1704294321,46,COMPLETED
5315270,1,1,1704294274,1704294275,1704294316,41,COMPLETED
5315271,1,1,1704294274,1704294275,1704294318,43,COMPLETED
5315272,1,1,1704294274,1704294275,1704294319,44,COMPLETED
5315273,1,1,1704294275,1704294275,1704294320,45,COMPLETED
5315274,1,1,1704294275,1704294275,1704294316,41,COMPLETED
5315275,1,1,1704294275,1704294275,1704294316,41,COMPLETED
5315276,1,1,1704294275,1704294275,1704294317,42,COMPLETED
5315277,1,1,1704294275,1704294277,1704294318,41,COMPLETED
5315278,1,1,1704294275,1704294277,1704294318,41,COMPLETED
5315279,1,1,1704294275,1704294277,1704294318,41,COMPLETED
5315280,1,1,1704294275,1704294277,1704294321,44,COMPLETED
5315281,1,1,1704294275,1704294277,1704294316,39,COMPLETED
5315282,1,1,1704294275,1704294277,1704294321,44,COMPLETED
5315283,1,1,1704294276,1704294277,1704294321,44,COMPLETED
5315284,1,1,1704294276,1704294277,1704294321,44,COMPLETED
5315285,1,1,1704294276,1704294277,1704294317,40,COMPLETED
5315286,1,1,1704294276,1704294277,1704294319,42,COMPLETED
5315287,1,1,1704294276,1704294277,1704294319,42,COMPLETED
5315288,1,1,1704294276,1704294277,1704294316,39,COMPLETED
5315289,1,1,1704294276,1704294277,1704294316,39,COMPLETED
5315290,1,1,1704294276,1704294277,1704294322,45,COMPLETED
5315291,1,1,1704294276,1704294277,1704294319,42,COMPLETED
5315292,1,1,1704294276,1704294277,1704294316,39,COMPLETED
5315293,1,1,1704294277,1704294277,1704294319,42,COMPLETED
5315294,1,1,1704294277,1704294277,1704294325,48,COMPLETED
5315295,1,1,1704294277,1704294277,1704294316,39,COMPLETED
5315296,1,1,1704294277,1704294277,1704294321,44,COMPLETED
5315297,1,1,1704294277,1704294277,1704294320,43,COMPLETED
5315298,1,1,1704294277,1704294277,1704294325,48,COMPLETED
5315299,1,1,1704294277,1704294277,1704294316,39,COMPLETED
5315300,1,1,1704294277,1704294277,1704294318,41,COMPLETED
5315301,1,1,1704294277,1704294277,1704294319,42,COMPLETED
5315302,1,1,1704294277,1704294277,1704294319,42,COMPLETED
5315303,1,1,1704294278,1704294281,1704294316,35,COMPLETED
5315304,1,1,1704294278,1704294281,1704294321,40,COMPLETED
5315305,1,1,1704294278,1704294281,1704294318,37,COMPLETED
5315306,1,1,1704294278,1704294281,1704294316,35,COMPLETED
5315307,1,1,1704294278,1704294281,1704294317,36,COMPLETED
5315308,1,1,1704294278,1704294281,1704294318,37,COMPLETED
5315309,1,1,1704294278,1704294281,1704294317,36,COMPLETED
5315310,1,1,1704294278,1704294281,1704294317,36,COMPLETED
5315311,1,1,1704294278,1704294281,1704294316,35,COMPLETED
5315312,1,1,1704294278,1704294281,1704294316,35,COMPLETED
5315313,1,1,1704294279,1704294281,1704294316,35,COMPLETED
5315314,1,1,1704294279,1704294281,1704294316,35,COMPLETED
5315315,1,1,1704294279,1704294281,1704294316,35,COMPLETED
5315316,1,1,1704294279,1704294281,1704294319,38,COMPLETED
5315317,1,1,1704294279,1704294281,1704294319,38,COMPLETED
5315318,1,1,1704294279,1704294281,1704294319,38,COMPLETED
5315319,1,1,1704294279,1704294281,1704294316,35,COMPLETED
5315320,1,1,1704294279,1704294281,1704294316,35,COMPLETED
5315321,1,1,1704294279,1704294281,1704294317,36,COMPLETED
5315322,1,1,1704294279,1704294281,1704294316,35,COMPLETED
5315323,1,1,1704294280,1704294281,1704294316,35,COMPLETED
5315324,1,1,1704294280,1704294281,1704294316,35,COMPLETED
5315325,1,1,1704294280,1704294281,1704294316,35,COMPLETED
5315326,1,1,1704294280,1704294281,1704294317,36,COMPLETED
5315327,1,1,1704294280,1704294281,1704294316,35,COMPLETED
5315328,1,1,1704294357,1704294357,1704294411,54,COMPLETED
5315329,1,1,1704294357,1704294357,1704294409,52,COMPLETED
5315330,1,1,1704294357,1704294357,1704294413,56,COMPLETED
5315331,1,1,1704294357,1704294357,1704294409,52,COMPLETED
5315332,1,1,1704294357,1704294361,1704294411,50,COMPLETED
5315333,1,1,1704294357,1704294361,1704294418,57,COMPLETED
5315334,1,1,1704294357,1704294361,1704294411,50,COMPLETED
5315335,1,1,1704294357,1704294361,1704294411,50,COMPLETED
5315336,1,1,1704294357,1704294361,1704294409,48,COMPLETED
5315337,1,1,1704294357,1704294361,1704294415,54,COMPLETED
5315338,1,1,1704294357,1704294361,1704294409,48,COMPLETED
5315339,1,1,1704294357,1704294361,1704294413,52,COMPLETED
5315340,1,1,1704294357,1704294361,1704294413,52,COMPLETED
5315341,1,1,1704294357,1704294361,1704294409,48,COMPLETED
5315342,1,1,1704294357,1704294361,1704294415,54,COMPLETED
5315343,1,1,1704294357,1704294361,1704294409,48,COMPLETED
5315344,1,1,1704294357,1704294361,1704294413,52,COMPLETED
5315345,1,1,1704294357,1704294361,1704294411,50,COMPLETED
5315346,1,1,1704294357,1704294361,1704294411,50,COMPLETED
5315347,1,1,1704294357,1704294361,1704294413,52,COMPLETED
5315348,1,1,1704294357,1704294361,1704294409,48,COMPLETED
5315349,1,1,1704294357,1704294361,1704294411,50,COMPLETED
5315350,1,1,1704294357,1704294361,1704294411,50,COMPLETED
5315351,1,1,1704294357,1704294361,1704294411,50,COMPLETED
5315352,1,1,1704294357,1704294361,1704294411,50,COMPLETED
5315353,1,1,1704294358,1704294361,1704294411,50,COMPLETED
5315354,1,1,1704294358,1704294361,1704294413,52,COMPLETED
5315355,1,1,1704294358,1704294361,1704294413,52,COMPLETED
5315356,1,1,1704294358,1704294361,1704294409,48,COMPLETED
5315357,1,1,1704294358,1704294361,1704294413,52,COMPLETED
5315358,1,1,1704294358,1704294361,1704294413,52,COMPLETED
5315359,1,1,1704294358,1704294361,1704294411,50,COMPLETED
5315360,1,1,1704294358,1704294361,1704294409,48,COMPLETED
5315361,1,1,1704294358,1704294361,1704294409,48,COMPLETED
5315362,1,1,1704294358,1704294361,1704294413,52,COMPLETED
5315363,1,1,1704294358,1704294361,1704294410,49,COMPLETED
5315364,1,1,1704294358,1704294361,1704294413,52,COMPLETED
5315365,1,1,1704294358,1704294361,1704294410,49,COMPLETED
5315366,1,1,1704294358,1704294361,1704294410,49,COMPLETED
5315367,1,1,1704294358,1704294361,1704294412,51,COMPLETED
5315368,1,1,1704294358,1704294361,1704294412,51,COMPLETED
5315369,1,1,1704294358,1704294361,1704294409,48,COMPLETED
5315370,1,1,1704294358,1704294361,1704294410,49,COMPLETED
5315371,1,1,1704294358,1704294361,1704294409,48,COMPLETED
5315372,1,1,1704294358,1704294361,1704294413,52,COMPLETED
5315373,1,1,1704294358,1704294361,1704294411,50,COMPLETED
5315374,1,1,1704294358,1704294361,1704294412,51,COMPLETED
5315375,1,1,1704294358,1704294361,1704294410,49,COMPLETED
5315376,1,1,1704294358,1704294361,1704294413,52,COMPLETED
5315377,1,1,1704294358,1704294361,1704294409,48,COMPLETED
5315378,1,1,1704294358,1704294361,1704294417,56,COMPLETED
5315379,1,1,1704294358,1704294361,1704294412,51,COMPLETED
5315380,1,1,1704294358,1704294361,1704294412,51,COMPLETED
5315381,1,1,1704294358,1704294361,1704294409,48,COMPLETED
5315382,1,1,1704294358,1704294361,1704294411,50,COMPLETED
5315383,1,1,1704294358,1704294361,1704294411,50,COMPLETED
5315384,1,1,1704294359,1704294361,1704294409,48,COMPLETED
5315385,1,1,1704294359,1704294361,1704294413,52,COMPLETED
5315386,1,1,1704294359,1704294361,1704294412,51,COMPLETED
5315387,1,1,1704294359,1704294361,1704294412,51,COMPLETED
5315388,1,1,1704294359,1704294361,1704294412,51,COMPLETED
5315389,1,1,1704294359,1704294361,1704294410,49,COMPLETED
5315390,1,1,1704294359,1704294361,1704294413,52,COMPLETED
5315391,1,1,1704294359,1704294361,1704294412,51,COMPLETED
5315392,1,1,1704294359,1704294361,1704294411,50,COMPLETED
5315393,1,1,1704294359,1704294361,1704294414,53,COMPLETED
5315394,1,1,1704294359,1704294361,1704294412,51,COMPLETED
5315395,1,1,1704294359,1704294361,1704294409,48,COMPLETED
5315396,1,1,1704294359,1704294361,1704294409,48,COMPLETED
5315397,1,1,1704294359,1704294361,1704294410,49,COMPLETED
5315398,1,1,1704294359,1704294361,1704294409,48,COMPLETED
5315399,1,1,1704294359,1704294361,1704294410,49,COMPLETED
5315400,1,1,1704294359,1704294361,1704294411,50,COMPLETED
5315401,1,1,1704294359,1704294361,1704294409,48,COMPLETED
5315402,1,1,1704294359,1704294361,1704294411,50,COMPLETED
5315403,1,1,1704294359,1704294361,1704294414,53,COMPLETED
5315404,1,1,1704294359,1704294361,1704294411,50,COMPLETED
5315405,1,1,1704294359,1704294361,1704294409,48,COMPLETED
5315406,1,1,1704294359,1704294361,1704294409,48,COMPLETED
5315407,1,1,1704294359,1704294361,1704294411,50,COMPLETED
5315408,1,1,1704294359,1704294361,1704294409,48,COMPLETED
5315409,1,1,1704294359,1704294361,1704294416,55,COMPLETED
5315410,1,1,1704294359,1704294361,1704294409,48,COMPLETED
5315411,1,1,1704294359,1704294361,1704294411,50,COMPLETED
5315412,1,1,1704294359,1704294361,1704294409,48,COMPLETED
5315413,1,1,1704294359,1704294361,1704294409,48,COMPLETED
5315414,1,1,1704294360,1704294361,1704294409,48,COMPLETED
5315415,1,1,1704294360,1704294361,1704294416,55,COMPLETED
5315416,1,1,1704294360,1704294361,1704294413,52,COMPLETED
5315417,1,1,1704294360,1704294361,1704294411,50,COMPLETED
5315418,1,1,1704294360,1704294361,1704294416,55,COMPLETED
5315419,1,1,1704294360,1704294361,1704294409,48,COMPLETED
5315420,1,1,1704294360,1704294361,1704294409,48,COMPLETED
5315421,1,1,1704294360,1704294361,1704294411,50,COMPLETED
5315422,1,1,1704294360,1704294361,1704294416,55,COMPLETED
5315423,1,1,1704294360,1704294361,1704294409,48,COMPLETED
5315424,1,1,1704294360,1704294361,1704294409,48,COMPLETED
5315425,1,1,1704294360,1704294361,1704294418,57,COMPLETED
5315426,1,1,1704294360,1704294361,1704294409,48,COMPLETED
5315427,1,1,1704294360,1704294361,1704294410,49,COMPLETED
5315428,1,1,1704294360,1704294361,1704294411,50,COMPLETED
5315429,1,1,1704294360,1704294361,1704294409,48,COMPLETED
5315430,1,1,1704294360,1704294361,1704294409,48,COMPLETED
5315431,1,1,1704294360,1704294361,1704294419,58,COMPLETED
5315432,1,1,1704294360,1704294361,1704294415,54,COMPLETED
5315433,1,1,1704294360,1704294361,1704294411,50,COMPLETED
5315434,1,1,1704294360,1704294361,1704294411,50,COMPLETED
5315435,1,1,1704294360,1704294361,1704294412,51,COMPLETED
5315436,1,1,1704294360,1704294361,1704294412,51,COMPLETED
5315437,1,1,1704294360,1704294361,1704294411,50,COMPLETED
5315438,1,1,1704294360,1704294361,1704294411,50,COMPLETED
5315439,1,1,1704294360,1704294361,1704294413,52,COMPLETED
5315440,1,1,1704294360,1704294361,1704294411,50,COMPLETED
5315441,1,1,1704294360,1704294361,1704294409,48,COMPLETED
5315442,1,1,1704294360,1704294361,1704294412,51,COMPLETED
5315443,1,1,1704294361,1704294361,1704294411,50,COMPLETED
5315444,1,1,1704294361,1704294361,1704294412,51,COMPLETED
5315445,1,1,1704294361,1704294361,1704294409,48,COMPLETED
5315446,1,1,1704294361,1704294361,1704294409,48,COMPLETED
5315447,1,1,1704294361,1704294361,1704294411,50,COMPLETED
5315448,1,1,1704294361,1704294361,1704294411,50,COMPLETED
5315449,1,1,1704294361,1704294361,1704294416,55,COMPLETED
5315450,1,1,1704294361,1704294361,1704294409,48,COMPLETED
5315451,1,1,1704294361,1704294365,1704294411,46,COMPLETED
5315452,1,1,1704294361,1704294365,1704294416,51,COMPLETED
5315453,1,1,1704294361,1704294365,1704294411,46,COMPLETED
5315454,1,1,1704294361,1704294365,1704294411,46,COMPLETED
5315455,1,1,1704294362,1704294365,1704294409,44,COMPLETED
5315456,1,1,1704294362,1704294365,1704294411,46,COMPLETED
5315457,1,1,1704294362,1704294365,1704294409,44,COMPLETED
5315458,1,1,1704294362,1704294365,1704294409,44,COMPLETED
5315459,1,1,1704294362,1704294365,1704294411,46,COMPLETED
5315460,1,1,1704294362,1704294365,1704294409,44,COMPLETED
5315461,1,1,1704294362,1704294365,1704294411,46,COMPLETED
5315462,1,1,1704294362,1704294365,1704294418,53,COMPLETED
5315463,1,1,1704294362,1704294365,1704294409,44,COMPLETED
5315464,1,1,1704294362,1704294365,1704294411,46,COMPLETED
5315465,1,1,1704294362,1704294365,1704294409,44,COMPLETED
5315466,1,1,1704294362,1704294365,1704294412,47,COMPLETED
5315467,1,1,1704294362,1704294365,1704294411,46,COMPLETED
5315468,1,1,1704294363,1704294365,1704294412,47,COMPLETED
5315469,1,1,1704294363,1704294365,1704294411,46,COMPLETED
5315470,1,1,1704294363,1704294365,1704294417,52,COMPLETED
5315471,1,1,1704294363,1704294365,1704294410,45,COMPLETED
5315472,1,1,1704294363,1704294365,1704294410,45,COMPLETED
5315473,1,1,1704294363,1704294365,1704294410,45,COMPLETED
5315474,1,1,1704294363,1704294365,1704294411,46,COMPLETED
5315475,1,1,1704294363,1704294365,1704294410,45,COMPLETED
5315476,1,1,1704294363,1704294365,1704294410,45,COMPLETED
5315477,1,1,1704294363,1704294365,1704294412,47,COMPLETED
5315478,1,1,1704294363,1704294365,1704294410,45,COMPLETED
5315479,1,1,1704294363,1704294365,1704294414,49,COMPLETED
5315480,1,1,1704294363,1704294365,1704294410,45,COMPLETED
5315481,1,1,1704294363,1704294365,1704294410,45,COMPLETED
5315482,1,1,1704294363,1704294365,1704294412,47,COMPLETED
5315483,1,1,1704294363,1704294365,1704294410,45,COMPLETED
5315484,1,1,1704294363,1704294365,1704294411,46,COMPLETED
5315485,1,1,1704294363,1704294365,1704294412,47,COMPLETED
5315486,1,1,1704294363,1704294365,1704294410,45,COMPLETED
5315487,1,1,1704294363,1704294365,1704294410,45,COMPLETED
5315488,1,1,1704294363,1704294365,1704294410,45,COMPLETED
5315489,1,1,1704294363,1704294365,1704294410,45,COMPLETED
5315490,1,1,1704294363,1704294365,1704294412,47,COMPLETED
5315491,1,1,1704294363,1704294365,1704294413,48,COMPLETED
5315492,1,1,1704294363,1704294365,1704294413,48,COMPLETED
5315493,1,1,1704294363,1704294365,1704294412,47,COMPLETED
5315494,1,1,1704294363,1704294365,1704294410,45,COMPLETED
5315495,1,1,1704294363,1704294365,1704294411,46,COMPLETED
5315496,1,1,1704294364,1704294365,1704294412,47,COMPLETED
5315497,1,1,1704294364,1704294365,1704294410,45,COMPLETED
5315498,1,1,1704294364,1704294365,1704294410,45,COMPLETED
5315499,1,1,1704294364,1704294365,1704294411,46,COMPLETED
5315500,1,1,1704294364,1704294365,1704294410,45,COMPLETED
5315501,1,1,1704294364,1704294365,1704294410,45,COMPLETED
5315502,1,1,1704294364,1704294365,1704294411,46,COMPLETED
5315503,1,1,1704294364,1704294365,1704294410,45,COMPLETED
5315504,1,1,1704294364,1704294365,1704294410,45,COMPLETED
5315505,1,1,1704294364,1704294365,1704294412,47,COMPLETED
5315506,1,1,1704294364,1704294365,1704294410,45,COMPLETED
5315507,1,1,1704294364,1704294365,1704294409,44,COMPLETED
5315508,1,1,1704294364,1704294365,1704294409,44,COMPLETED
5315509,1,1,1704294364,1704294365,1704294409,44,COMPLETED
5315510,1,1,1704294364,1704294365,1704294409,44,COMPLETED
5315511,1,1,1704294364,1704294365,1704294410,45,COMPLETED
5315512,1,1,1704294364,1704294365,1704294410,45,COMPLETED
5315513,1,1,1704294364,1704294365,1704294409,44,COMPLETED
5315514,1,1,1704294364,1704294365,1704294409,44,COMPLETED
5315515,1,1,1704294364,1704294365,1704294409,44,COMPLETED
5315516,1,1,1704294364,1704294365,1704294409,44,COMPLETED
5315517,1,1,1704294364,1704294365,1704294409,44,COMPLETED
5315518,1,1,1704294364,1704294365,1704294409,44,COMPLETED
5315519,1,1,1704294364,1704294365,1704294409,44,COMPLETED
5315520,1,1,1704294364,1704294365,1704294414,49,COMPLETED
5315521,1,1,1704294365,1704294365,1704294409,44,COMPLETED
5315522,1,1,1704294365,1704294365,1704294409,44,COMPLETED
5315523,1,1,1704294365,1704294365,1704294409,44,COMPLETED
5315524,1,1,1704294365,1704294365,1704294409,44,COMPLETED
5315525,1,1,1704294365,1704294365,1704294409,44,COMPLETED
5315526,1,1,1704294365,1704294365,1704294409,44,COMPLETED
5315527,1,1,1704294365,1704294365,1704294409,44,COMPLETED
5315528,1,1,1704294410,1704294411,1704294437,26,COMPLETED
5315529,1,1,1704294410,1704294411,1704294437,26,COMPLETED
5315530,1,1,1704294410,1704294411,1704294437,26,COMPLETED
5315531,1,1,1704294411,1704294411,1704294437,26,COMPLETED
5315532,1,1,1704294411,1704294411,1704294437,26,COMPLETED
5315533,1,1,1704294412,1704294412,1704294448,36,COMPLETED
5315534,1,1,1704294412,1704294412,1704294446,34,COMPLETED
5315535,1,1,1704294412,1704294412,1704294448,36,COMPLETED
5315536,1,1,1704294412,1704294412,1704294446,34,COMPLETED
5315537,1,1,1704294412,1704294412,1704294458,46,COMPLETED
5315538,1,1,1704294412,1704294412,1704294448,36,COMPLETED
5315539,1,1,1704294412,1704294412,1704294455,43,COMPLETED
5315540,1,1,1704294421,1704294422,1704294448,26,COMPLETED
5315541,1,1,1704294421,1704294422,1704294448,26,COMPLETED
5315542,1,1,1704294421,1704294422,1704294448,26,COMPLETED
5315543,1,1,1704294421,1704294422,1704294448,26,COMPLETED
5315544,1,1,1704294421,1704294422,1704294446,24,COMPLETED
5315545,1,1,1704294422,1704294422,1704294446,24,COMPLETED
5315546,1,1,1704294422,1704294422,1704294448,26,COMPLETED
5315547,1,1,1704294422,1704294426,1704294454,28,COMPLETED
5315548,1,1,1704294422,1704294426,1704294454,28,COMPLETED
5315549,1,1,1704294422,1704294426,1704294454,28,COMPLETED
5315550,1,1,1704294422,1704294426,1704294506,80,COMPLETED
5315551,1,1,1704294422,1704294426,1704294454,28,COMPLETED
5315552,1,1,1704294422,1704294426,1704294454,28,COMPLETED
5315553,1,1,1704294422,1704294426,1704294455,29,COMPLETED
5315554,1,1,1704294422,1704294426,1704294454,28,COMPLETED
5315555,1,1,1704294422,1704294426,1704294454,28,COMPLETED
5315556,1,1,1704294423,1704294426,1704294455,29,COMPLETED
5315557,1,1,1704294423,1704294426,1704294454,28,COMPLETED
5315558,1,1,1704294423,1704294426,1704294454,28,COMPLETED
5315559,1,1,1704294423,1704294426,1704294454,28,COMPLETED
5315560,1,1,1704294423,1704294426,1704294457,31,COMPLETED
5315561,1,1,1704294423,1704294426,1704294454,28,COMPLETED
5315562,1,1,1704294423,1704294426,1704294454,28,COMPLETED
5315563,1,1,1704294423,1704294426,1704294456,30,COMPLETED
5315564,1,1,1704294423,1704294426,1704294454,28,COMPLETED
5315565,1,1,1704294424,1704294426,1704294454,28,COMPLETED
5315566,1,1,1704294424,1704294426,1704294454,28,COMPLETED
5315567,1,1,1704294424,1704294426,1704294454,28,COMPLETED
5315568,1,1,1704294424,1704294426,1704294454,28,COMPLETED
5315569,1,1,1704294424,1704294426,1704294454,28,COMPLETED
5315570,1,1,1704294424,1704294426,1704294452,26,COMPLETED
5315571,1,1,1704294425,1704294426,1704294454,28,COMPLETED
5315572,1,1,1704294425,1704294426,1704294450,24,COMPLETED
5315573,1,1,1704294425,1704294426,1704294461,35,COMPLETED
5315574,1,1,1704294425,1704294426,1704294454,28,COMPLETED
5315575,1,1,1704294425,1704294426,1704294457,31,COMPLETED
5315576,1,1,1704294425,1704294426,1704294450,24,COMPLETED
5315577,1,1,1704294425,1704294426,1704294452,26,COMPLETED
5315578,1,1,1704294425,1704294426,1704294461,35,COMPLETED
5315579,1,1,1704294425,1704294426,1704294454,28,COMPLETED
5315580,1,1,1704294425,1704294426,1704294452,26,COMPLETED
5315581,1,1,1704294425,1704294426,1704294457,31,COMPLETED
5315582,1,1,1704294426,1704294426,1704294452,26,COMPLETED
5315583,1,1,1704294426,1704294426,1704294457,31,COMPLETED
5315584,1,1,1704294426,1704294426,1704294463,37,COMPLETED
5315585,1,1,1704294426,1704294426,1704294450,24,COMPLETED
5315586,1,1,1704294426,1704294426,1704294452,26,COMPLETED
5315587,1,1,1704294426,1704294430,1704294457,27,COMPLETED
5315588,1,1,1704294426,1704294430,1704294460,30,COMPLETED
5315589,1,1,1704294427,1704294430,1704294459,29,COMPLETED
5315590,1,1,1704294427,1704294430,1704294460,30,COMPLETED
5315591,1,1,1704294427,1704294430,1704294458,28,COMPLETED
5315592,1,1,1704294427,1704294430,1704294459,29,COMPLETED
5315593,1,1,1704294427,1704294430,1704294459,29,COMPLETED
5315594,1,1,1704294427,1704294430,1704294459,29,COMPLETED
5315595,1,1,1704294427,1704294430,1704294460,30,COMPLETED
5315596,1,1,1704294427,1704294430,1704294460,30,COMPLETED
5315597,1,1,1704294427,1704294430,1704294460,30,COMPLETED
5315598,1,1,1704294427,1704294430,1704294459,29,COMPLETED
5315599,1,1,1704294427,1704294430,1704294458,28,COMPLETED
5315600,1,1,1704294427,1704294430,1704294461,31,COMPLETED
5315601,1,1,1704294427,1704294430,1704294459,29,COMPLETED
5315602,1,1,1704294427,1704294430,1704294459,29,COMPLETED
5315603,1,1,1704294427,1704294430,1704294462,32,COMPLETED
5315604,1,1,1704294427,1704294430,1704294457,27,COMPLETED
5315605,1,1,1704294428,1704294430,1704294458,28,COMPLETED
5315606,1,1,1704294428,1704294430,1704294458,28,COMPLETED
5315607,1,1,1704294428,1704294430,1704294455,25,COMPLETED
5315608,1,1,1704294428,1704294430,1704294456,26,COMPLETED
5315609,1,1,1704294429,1704294430,1704294457,27,COMPLETED
5315610,1,1,1704294429,1704294430,1704294461,31,COMPLETED
5315611,1,1,1704294429,1704294430,1704294458,28,COMPLETED
5315612,1,1,1704294429,1704294430,1704294457,27,COMPLETED
5315613,1,1,1704294429,1704294430,1704294457,27,COMPLETED
5315614,1,1,1704294429,1704294430,1704294457,27,COMPLETED
5315615,1,1,1704294429,1704294430,1704294457,27,COMPLETED
5315616,1,1,1704294429,1704294430,1704294457,27,COMPLETED
5315617,1,1,1704294429,1704294430,1704294457,27,COMPLETED
5315618,1,1,1704294429,1704294430,1704294458,28,COMPLETED
5315619,1,1,1704294429,1704294430,1704294458,28,COMPLETED
5315620,1,1,1704294429,1704294430,1704294458,28,COMPLETED
5315621,1,1,1704294429,1704294430,1704294459,29,COMPLETED
5315622,1,1,1704294429,1704294430,1704294457,27,COMPLETED
5315623,1,1,1704294429,1704294430,1704294457,27,COMPLETED
5315624,1,1,1704294430,1704294430,1704294458,28,COMPLETED
5315625,1,1,1704294430,1704294430,1704294457,27,COMPLETED
5315626,1,1,1704294430,1704294430,1704294458,28,COMPLETED
5315627,1,1,1704294430,1704294434,1704294474,40,COMPLETED
5315628,1,1,1704294430,1704294434,1704294474,40,COMPLETED
5315629,1,1,1704294430,1704294434,1704294474,40,COMPLETED
5315630,1,1,1704294430,1704294434,1704294474,40,COMPLETED
5315631,1,1,1704294431,1704294434,1704294475,41,COMPLETED
5315632,1,1,1704294431,1704294434,1704294474,40,COMPLETED
5315633,1,1,1704294431,1704294434,1704294475,41,COMPLETED
5315634,1,1,1704294431,1704294434,1704294474,40,COMPLETED
5315635,1,1,1704294431,1704294434,1704294480,46,COMPLETED
5315636,1,1,1704294431,1704294434,1704294474,40,COMPLETED
5315637,1,1,1704294431,1704294434,1704294475,41,COMPLETED
5315638,1,1,1704294431,1704294434,1704294474,40,COMPLETED
5315639,1,1,1704294431,1704294434,1704294474,40,COMPLETED
5315640,1,1,1704294431,1704294434,1704294474,40,COMPLETED
5315641,1,1,1704294431,1704294434,1704294474,40,COMPLETED
5315642,1,1,1704294431,1704294434,1704294474,40,COMPLETED
5315643,1,1,1704294431,1704294434,1704294474,40,COMPLETED
5315644,1,1,1704294432,1704294434,1704294474,40,COMPLETED
5315645,1,1,1704294432,1704294434,1704294474,40,COMPLETED
5315646,1,1,1704294432,1704294434,1704294474,40,COMPLETED
5315647,36,1,1704294435,1704294438,1704297453,3015,COMPLETED
5315648,1,1,1704294523,1704294523,1704294572,49,COMPLETED
5315649,1,1,1704294523,1704294523,1704294573,50,COMPLETED
5315650,1,1,1704294523,1704294523,1704294574,51,COMPLETED
5315651,1,1,1704294523,1704294523,1704294580,57,COMPLETED
5315652,1,1,1704294523,1704294523,1704294572,49,COMPLETED
5315653,1,1,1704294523,1704294523,1704294572,49,COMPLETED
5315654,1,1,1704294523,1704294523,1704294572,49,COMPLETED
5315655,1,1,1704294523,1704294523,1704294573,50,COMPLETED
5315656,1,1,1704294523,1704294523,1704294572,49,COMPLETED
5315657,1,1,1704294523,1704294523,1704294581,58,COMPLETED
5315658,1,1,1704294523,1704294527,1704294579,52,COMPLETED
5315659,1,1,1704294524,1704294527,1704294572,45,COMPLETED
5315660,1,1,1704294524,1704294527,1704294577,50,COMPLETED
5315661,1,1,1704294524,1704294527,1704294572,45,COMPLETED
5315662,1,1,1704294524,1704294527,1704294577,50,COMPLETED
5315663,1,1,1704294524,1704294527,1704294580,53,COMPLETED
5315664,1,1,1704294524,1704294527,1704294572,45,COMPLETED
5315665,1,1,1704294524,1704294527,1704294577,50,COMPLETED
5315666,1,1,1704294524,1704294527,1704294578,51,COMPLETED
5315667,1,1,1704294524,1704294527,1704294572,45,COMPLETED
5315668,1,1,1704294524,1704294527,1704294572,45,COMPLETED
5315669,1,1,1704294524,1704294527,1704294573,46,COMPLETED
5315670,1,1,1704294524,1704294527,1704294572,45,COMPLETED
5315671,1,1,1704294524,1704294527,1704294572,45,COMPLETED
5315672,1,1,1704294524,1704294527,1704294572,45,COMPLETED
5315673,1,1,1704294524,1704294527,1704294572,45,COMPLETED
5315674,1,1,1704294524,1704294527,1704294572,45,COMPLETED
5315675,1,1,1704294524,1704294527,1704294580,53,COMPLETED
5315676,1,1,1704294524,1704294527,1704294572,45,COMPLETED
5315677,1,1,1704294524,1704294527,1704294581,54,COMPLETED
5315678,1,1,1704294524,1704294527,1704294578,51,COMPLETED
5315679,1,1,1704294524,1704294527,1704294573,46,COMPLETED
5315680,1,1,1704294524,1704294527,1704294572,45,COMPLETED
5315681,1,1,1704294524,1704294527,1704294572,45,COMPLETED
5315682,1,1,1704294524,1704294527,1704294579,52,COMPLETED
5315683,1,1,1704294524,1704294527,1704294572,45,COMPLETED
5315684,1,1,1704294524,1704294527,1704294572,45,COMPLETED
5315685,1,1,1704294524,1704294527,1704294572,45,COMPLETED
5315686,1,1,1704294525,1704294527,1704294572,45,COMPLETED
5315687,1,1,1704294525,1704294527,1704294572,45,COMPLETED
5315688,1,1,1704294525,1704294527,1704294575,48,COMPLETED
5315689,1,1,1704294525,1704294527,1704294577,50,COMPLETED
5315690,1,1,1704294525,1704294527,1704294572,45,COMPLETED
5315691,1,1,1704294525,1704294527,1704294572,45,COMPLETED
5315692,1,1,1704294525,1704294527,1704294572,45,COMPLETED
5315693,1,1,1704294525,1704294527,1704294575,48,COMPLETED
5315694,1,1,1704294525,1704294527,1704294573,46,COMPLETED
5315695,1,1,1704294525,1704294527,1704294573,46,COMPLETED
5315696,1,1,1704294525,1704294527,1704294573,46,COMPLETED
5315697,1,1,1704294525,1704294527,1704294573,46,COMPLETED
5315698,1,1,1704294525,1704294527,1704294572,45,COMPLETED
5315699,1,1,1704294525,1704294527,1704294579,52,COMPLETED
5315700,1,1,1704294525,1704294527,1704294572,45,COMPLETED
5315701,1,1,1704294525,1704294527,1704294573,46,COMPLETED
5315702,1,1,1704294525,1704294527,1704294572,45,COMPLETED
5315703,1,1,1704294525,1704294527,1704294579,52,COMPLETED
5315704,1,1,1704294525,1704294527,1704294582,55,COMPLETED
5315705,1,1,1704294525,1704294527,1704294572,45,COMPLETED
5315706,1,1,1704294525,1704294527,1704294580,53,COMPLETED
5315707,1,1,1704294525,1704294527,1704294572,45,COMPLETED
5315708,1,1,1704294525,1704294527,1704294572,45,COMPLETED
5315709,1,1,1704294525,1704294527,1704294572,45,COMPLETED
5315710,1,1,1704294525,1704294527,1704294577,50,COMPLETED
5315711,1,1,1704294525,1704294527,1704294573,46,COMPLETED
5315712,1,1,1704294525,1704294527,1704294580,53,COMPLETED
5315713,1,1,1704294525,1704294527,1704294573,46,COMPLETED
5315714,1,1,1704294525,1704294527,1704294573,46,COMPLETED
5315715,1,1,1704294525,1704294527,1704294573,46,COMPLETED
5315716,1,1,1704294525,1704294527,1704294572,45,COMPLETED
5315717,1,1,1704294525,1704294527,1704294573,46,COMPLETED
5315718,1,1,1704294525,1704294527,1704294572,45,COMPLETED
5315719,1,1,1704294525,1704294527,1704294582,55,COMPLETED
5315720,1,1,1704294525,1704294527,1704294574,47,COMPLETED
5315721,1,1,1704294526,1704294527,1704294572,45,COMPLETED
5315722,1,1,1704294526,1704294527,1704294573,46,COMPLETED
5315723,1,1,1704294526,1704294527,1704294581,54,COMPLETED
5315724,1,1,1704294526,1704294527,1704294575,48,COMPLETED
5315725,1,1,1704294526,1704294527,1704294572,45,COMPLETED
5315726,1,1,1704294526,1704294527,1704294575,48,COMPLETED
5315727,1,1,1704294526,1704294527,1704294575,48,COMPLETED
5315728,1,1,1704294526,1704294527,1704294575,48,COMPLETED
5315729,1,1,1704294526,1704294527,1704294575,48,COMPLETED
5315730,1,1,1704294526,1704294527,1704294572,45,COMPLETED
5315731,1,1,1704294526,1704294527,1704294572,45,COMPLETED
5315732,1,1,1704294526,1704294527,1704294581,54,COMPLETED
5315733,1,1,1704294526,1704294527,1704294581,54,COMPLETED
5315734,1,1,1704294526,1704294527,1704294572,45,COMPLETED
5315735,1,1,1704294526,1704294527,1704294577,50,COMPLETED
5315736,1,1,1704294526,1704294527,1704294572,45,COMPLETED
5315737,1,1,1704294526,1704294527,1704294572,45,COMPLETED
5315738,1,1,1704294526,1704294527,1704294573,46,COMPLETED
5315739,1,1,1704294526,1704294527,1704294580,53,COMPLETED
5315740,1,1,1704294526,1704294527,1704294575,48,COMPLETED
5315741,1,1,1704294526,1704294527,1704294572,45,COMPLETED
5315742,1,1,1704294526,1704294527,1704294572,45,COMPLETED
5315743,1,1,1704294526,1704294527,1704294577,50,COMPLETED
5315744,1,1,1704294526,1704294527,1704294582,55,COMPLETED
5315745,1,1,1704294526,1704294527,1704294572,45,COMPLETED
5315746,1,1,1704294526,1704294527,1704294572,45,COMPLETED
5315747,1,1,1704294526,1704294527,1704294574,47,COMPLETED
5315748,1,1,1704294526,1704294527,1704294581,54,COMPLETED
5315749,1,1,1704294526,1704294527,1704294581,54,COMPLETED
5315750,1,1,1704294527,1704294527,1704294579,52,COMPLETED
5315751,1,1,1704294527,1704294527,1704294572,45,COMPLETED
5315752,1,1,1704294527,1704294527,1704294572,45,COMPLETED
5315753,1,1,1704294527,1704294527,1704294572,45,COMPLETED
5315754,1,1,1704294527,1704294527,1704294572,45,COMPLETED
5315755,1,1,1704294527,1704294527,1704294584,57,COMPLETED
5315756,1,1,1704294527,1704294527,1704294579,52,COMPLETED
5315757,1,1,1704294527,1704294527,1704294579,52,COMPLETED
5315758,1,1,1704294527,1704294527,1704294572,45,COMPLETED
5315759,1,1,1704294527,1704294527,1704294572,45,COMPLETED
5315760,1,1,1704294527,1704294527,1704294573,46,COMPLETED
5315761,1,1,1704294527,1704294527,1704294582,55,COMPLETED
5315762,1,1,1704294527,1704294527,1704294577,50,COMPLETED
5315763,1,1,1704294527,1704294527,1704294572,45,COMPLETED
5315764,1,1,1704294527,1704294527,1704294572,45,COMPLETED
5315765,1,1,1704294527,1704294527,1704294572,45,COMPLETED
5315766,1,1,1704294527,1704294527,1704294572,45,COMPLETED
5315767,1,1,1704294527,1704294527,1704294577,50,COMPLETED
5315768,1,1,1704294527,1704294527,1704294574,47,COMPLETED
5315769,1,1,1704294527,1704294527,1704294579,52,COMPLETED
5315770,1,1,1704294527,1704294527,1704294572,45,COMPLETED
5315771,1,1,1704294527,1704294527,1704294584,57,COMPLETED
5315772,1,1,1704294527,1704294527,1704294574,47,COMPLETED
5315773,1,1,1704294527,1704294527,1704294574,47,COMPLETED
5315774,1,1,1704294527,1704294527,1704294574,47,COMPLETED
5315775,1,1,1704294527,1704294527,1704294574,47,COMPLETED
5315776,1,1,1704294527,1704294527,1704294584,57,COMPLETED
5315777,1,1,1704294527,1704294527,1704294577,50,COMPLETED
5315778,1,1,1704294527,1704294527,1704294572,45,COMPLETED
5315779,1,1,1704294528,1704294531,1704294572,41,COMPLETED
5315780,1,1,1704294528,1704294531,1704294574,43,COMPLETED
5315781,1,1,1704294528,1704294531,1704294574,43,COMPLETED
5315782,1,1,1704294528,1704294531,1704294579,48,COMPLETED
5315783,1,1,1704294528,1704294531,1704294574,43,COMPLETED
5315784,1,1,1704294528,1704294531,1704294577,46,COMPLETED
5315785,1,1,1704294528,1704294531,1704294576,45,COMPLETED
5315786,1,1,1704294528,1704294531,1704294573,42,COMPLETED
5315787,1,1,1704294528,1704294531,1704294574,43,COMPLETED
5315788,1,1,1704294528,1704294531,1704294584,53,COMPLETED
5315789,1,1,1704294528,1704294531,1704294572,41,COMPLETED
5315790,1,1,1704294528,1704294531,1704294572,41,COMPLETED
5315791,1,1,1704294529,1704294531,1704294577,46,COMPLETED
5315792,1,1,1704294529,1704294531,1704294576,45,COMPLETED
5315793,1,1,1704294529,1704294531,1704294575,44,COMPLETED
5315794,1,1,1704294529,1704294531,1704294572,41,COMPLETED
5315795,1,1,1704294529,1704294531,1704294572,41,COMPLETED
5315796,1,1,1704294529,1704294531,1704294572,41,COMPLETED
5315797,1,1,1704294529,1704294531,1704294576,45,COMPLETED
5315798,1,1,1704294529,1704294531,1704294577,46,COMPLETED
5315799,1,1,1704294529,1704294531,1704294581,50,COMPLETED
5315800,1,1,1704294529,1704294531,1704294575,44,COMPLETED
5315801,1,1,1704294529,1704294531,1704294576,45,COMPLETED
5315802,1,1,1704294529,1704294531,1704294573,42,COMPLETED
5315803,1,1,1704294529,1704294531,1704294576,45,COMPLETED
5315804,1,1,1704294529,1704294531,1704294574,43,COMPLETED
5315805,1,1,1704294529,1704294531,1704294581,50,COMPLETED
5315806,1,1,1704294529,1704294531,1704294577,46,COMPLETED
5315807,1,1,1704294529,1704294531,1704294576,45,COMPLETED
5315808,1,1,1704294529,1704294531,1704294575,44,COMPLETED
5315809,1,1,1704294529,1704294531,1704294575,44,COMPLETED
5315810,1,1,1704294529,1704294531,1704294573,42,COMPLETED
5315811,1,1,1704294529,1704294531,1704294573,42,COMPLETED
5315812,1,1,1704294529,1704294531,1704294573,42,COMPLETED
5315813,1,1,1704294529,1704294531,1704294572,41,COMPLETED
5315814,1,1,1704294530,1704294531,1704294576,45,COMPLETED
5315815,1,1,1704294530,1704294531,1704294573,42,COMPLETED
5315816,1,1,1704294530,1704294531,1704294572,41,COMPLETED
5315817,1,1,1704294530,1704294531,1704294576,45,COMPLETED
5315818,1,1,1704294530,1704294531,1704294572,41,COMPLETED
5315819,1,1,1704294530,1704294531,1704294573,42,COMPLETED
5315820,1,1,1704294530,1704294531,1704294572,41,COMPLETED
5315821,1,1,1704294530,1704294531,1704294572,41,COMPLETED
5315822,1,1,1704294530,1704294531,1704294572,41,COMPLETED
5315823,1,1,1704294530,1704294531,1704294572,41,COMPLETED
5315824,1,1,1704294530,1704294531,1704294575,44,COMPLETED
5315825,1,1,1704294530,1704294531,1704294577,46,COMPLETED
5315826,1,1,1704294530,1704294531,1704294577,46,COMPLETED
5315827,1,1,1704294530,1704294531,1704294572,41,COMPLETED
5315828,1,1,1704294530,1704294531,1704294572,41,COMPLETED
5315829,1,1,1704294530,1704294531,1704294572,41,COMPLETED
5315830,1,1,1704294530,1704294531,1704294572,41,COMPLETED
5315831,1,1,1704294530,1704294531,1704294573,42,COMPLETED
5315832,1,1,1704294530,1704294531,1704294577,46,COMPLETED
5315833,1,1,1704294530,1704294531,1704294572,41,COMPLETED
5315834,1,1,1704294530,1704294531,1704294572,41,COMPLETED
5315835,1,1,1704294530,1704294531,1704294579,48,COMPLETED
5315836,1,1,1704294530,1704294531,1704294572,41,COMPLETED
5315837,1,1,1704294530,1704294531,1704294573,42,COMPLETED
5315838,1,1,1704294530,1704294531,1704294572,41,COMPLETED
5315839,1,1,1704294530,1704294531,1704294572,41,COMPLETED
5315840,1,1,1704294530,1704294531,1704294572,41,COMPLETED
5315841,1,1,1704294530,1704294531,1704294572,41,COMPLETED
5315842,1,1,1704294530,1704294531,1704294572,41,COMPLETED
5315843,1,1,1704294530,1704294531,1704294572,41,COMPLETED
5315844,1,1,1704294530,1704294531,1704294572,41,COMPLETED
5315845,1,1,1704294530,1704294531,1704294572,41,COMPLETED
5315846,1,1,1704294531,1704294531,1704294572,41,COMPLETED
5315847,1,1,1704294531,1704294531,1704294572,41,COMPLETED
5315848,1,1,1704294573,1704294573,1704294604,31,COMPLETED
5315849,1,1,1704294573,1704294573,1704294604,31,COMPLETED
5315850,1,1,1704294574,1704294574,1704294604,30,COMPLETED
5315851,1,1,1704294575,1704294575,1704294603,28,COMPLETED
5315852,1,1,1704294575,1704294575,1704294603,28,COMPLETED
5315853,1,1,1704294575,1704294575,1704294603,28,COMPLETED
5315854,1,1,1704294575,1704294575,1704294603,28,COMPLETED
5315855,1,1,1704294575,1704294575,1704294603,28,COMPLETED
5315856,1,1,1704294575,1704294575,1704294603,28,COMPLETED
5315857,1,1,1704294575,1704294575,1704294603,28,COMPLETED
5315858,1,1,1704294576,1704294576,1704294603,27,COMPLETED
5315859,1,1,1704294576,1704294576,1704294603,27,COMPLETED
5315860,1,1,1704294576,1704294576,1704294603,27,COMPLETED
5315861,1,1,1704294576,1704294576,1704294603,27,COMPLETED
5315862,1,1,1704294576,1704294576,1704294604,28,COMPLETED
5315863,1,1,1704294576,1704294576,1704294603,27,COMPLETED
5315864,1,1,1704294576,1704294576,1704294603,27,COMPLETED
5315865,1,1,1704294576,1704294576,1704294603,27,COMPLETED
5315866,1,1,1704294577,1704294578,1704294603,25,COMPLETED
5315867,1,1,1704294577,1704294578,1704294604,26,COMPLETED
5315868,1,1,1704294577,1704294578,1704294604,26,COMPLETED
5315869,1,1,1704294577,1704294578,1704294604,26,COMPLETED
5315870,1,1,1704294577,1704294578,1704294603,25,COMPLETED
5315871,1,1,1704294577,1704294578,1704294605,27,COMPLETED
5315872,1,1,1704294577,1704294578,1704294604,26,COMPLETED
5315873,1,1,1704294577,1704294578,1704294605,27,COMPLETED
5315874,1,1,1704294577,1704294578,1704294603,25,COMPLETED
5315875,1,1,1704294577,1704294578,1704294604,26,COMPLETED
5315876,1,1,1704294578,1704294578,1704294603,25,COMPLETED
5315877,1,1,1704294578,1704294578,1704294603,25,COMPLETED
5315878,1,1,1704294578,1704294578,1704294603,25,COMPLETED
5315879,1,1,1704294578,1704294578,1704294603,25,COMPLETED
5315880,1,1,1704294578,1704294578,1704294603,25,COMPLETED
5315881,1,1,1704294578,1704294578,1704294639,61,COMPLETED
5315882,1,1,1704294578,1704294578,1704294603,25,COMPLETED
5315883,1,1,1704294578,1704294579,1704294603,24,COMPLETED
5315884,1,1,1704294578,1704294579,1704294603,24,COMPLETED
5315885,1,1,1704294579,1704294580,1704294603,23,COMPLETED
5315886,1,1,1704294579,1704294580,1704294603,23,COMPLETED
5315887,1,1,1704294579,1704294580,1704294603,23,COMPLETED
5315888,1,1,1704294579,1704294580,1704294603,23,COMPLETED
5315889,1,1,1704294579,1704294580,1704294603,23,COMPLETED
5315890,1,1,1704294579,1704294580,1704294603,23,COMPLETED
5315891,1,1,1704294579,1704294580,1704294603,23,COMPLETED
5315892,1,1,1704294579,1704294580,1704294603,23,COMPLETED
5315893,1,1,1704294579,1704294580,1704294604,24,COMPLETED
5315894,1,1,1704294579,1704294580,1704294603,23,COMPLETED
5315895,1,1,1704294592,1704294593,1704294624,31,COMPLETED
5315896,1,1,1704294592,1704294593,1704294628,35,COMPLETED
5315897,1,1,1704294593,1704294597,1704294624,27,COMPLETED
5315898,1,1,1704294593,1704294597,1704294624,27,COMPLETED
5315899,1,1,1704294593,1704294597,1704294624,27,COMPLETED
5315900,1,1,1704294593,1704294597,1704294624,27,COMPLETED
5315901,1,1,1704294593,1704294597,1704294624,27,COMPLETED
5315902,1,1,1704294593,1704294597,1704294624,27,COMPLETED
5315903,1,1,1704294593,1704294597,1704294624,27,COMPLETED
5315904,1,1,1704294593,1704294597,1704294624,27,COMPLETED
5315905,1,1,1704294658,1704294659,1704294699,40,COMPLETED
5315906,1,1,1704294658,1704294659,1704294699,40,COMPLETED
5315907,1,1,1704294658,1704294659,1704294698,39,COMPLETED
5315908,1,1,1704294658,1704294659,1704294698,39,COMPLETED
5315909,1,1,1704294658,1704294659,1704294698,39,COMPLETED
5315910,1,1,1704294659,1704294659,1704294699,40,COMPLETED
5315911,1,1,1704294659,1704294659,1704294699,40,COMPLETED
5315912,1,1,1704294659,1704294659,1704294709,50,COMPLETED
5315913,1,1,1704294659,1704294659,1704294698,39,COMPLETED
5315914,1,1,1704294659,1704294659,1704294701,42,COMPLETED
5315915,1,1,1704294659,1704294659,1704294698,39,COMPLETED
5315916,1,1,1704294659,1704294659,1704294709,50,COMPLETED
5315917,1,1,1704294659,1704294659,1704294699,40,COMPLETED
5315918,1,1,1704294659,1704294659,1704294699,40,COMPLETED
5315919,1,1,1704294659,1704294659,1704294698,39,COMPLETED
5315920,1,1,1704294659,1704294659,1704294700,41,COMPLETED
5315921,1,1,1704294659,1704294659,1704294699,40,COMPLETED
5315922,1,1,1704294659,1704294659,1704294698,39,COMPLETED
5315923,1,1,1704294659,1704294659,1704294700,41,COMPLETED
5315924,1,1,1704294659,1704294659,1704294699,40,COMPLETED
5315925,1,1,1704294659,1704294659,1704294700,41,COMPLETED
5315926,1,1,1704294659,1704294659,1704294698,39,COMPLETED
5315927,1,1,1704294659,1704294659,1704294698,39,COMPLETED
5315928,1,1,1704294659,1704294659,1704294698,39,COMPLETED
5315929,1,1,1704294659,1704294659,1704294700,41,COMPLETED
5315930,1,1,1704294659,1704294659,1704294698,39,COMPLETED
5315931,1,1,1704294659,1704294659,1704294702,43,COMPLETED
5315932,1,1,1704294659,1704294663,1704294698,35,COMPLETED
5315933,1,1,1704294659,1704294663,1704294700,37,COMPLETED
5315934,1,1,1704294659,1704294663,1704294701,38,COMPLETED
5315935,1,1,1704294659,1704294663,1704294699,36,COMPLETED
5315936,1,1,1704294659,1704294663,1704294700,37,COMPLETED
5315937,1,1,1704294659,1704294663,1704294698,35,COMPLETED
5315938,1,1,1704294659,1704294663,1704294703,40,COMPLETED
5315939,1,1,1704294659,1704294663,1704294698,35,COMPLETED
5315940,1,1,1704294659,1704294663,1704294698,35,COMPLETED
5315941,1,1,1704294659,1704294663,1704294700,37,COMPLETED
5315942,1,1,1704294659,1704294663,1704294700,37,COMPLETED
5315943,1,1,1704294659,1704294663,1704294709,46,COMPLETED
5315944,1,1,1704294660,1704294663,1704294699,36,COMPLETED
5315945,1,1,1704294660,1704294663,1704294700,37,COMPLETED
5315946,1,1,1704294660,1704294663,1704294698,35,COMPLETED
5315947,1,1,1704294660,1704294663,1704294700,37,COMPLETED
5315948,1,1,1704294660,1704294663,1704294700,37,COMPLETED
5315949,1,1,1704294660,1704294663,1704294698,35,COMPLETED
5315950,1,1,1704294660,1704294663,1704294703,40,COMPLETED
5315951,1,1,1704294660,1704294663,1704294699,36,COMPLETED
5315952,1,1,1704294660,1704294663,1704294698,35,COMPLETED
5315953,1,1,1704294660,1704294663,1704294700,37,COMPLETED
5315954,1,1,1704294660,1704294663,1704294702,39,COMPLETED
5315955,1,1,1704294660,1704294663,1704294698,35,COMPLETED
5315956,1,1,1704294660,1704294663,1704294699,36,COMPLETED
5315957,1,1,1704294660,1704294663,1704294699,36,COMPLETED
5315958,1,1,1704294660,1704294663,1704294698,35,COMPLETED
5315959,1,1,1704294660,1704294663,1704294701,38,COMPLETED
5315960,1,1,1704294660,1704294663,1704294701,38,COMPLETED
5315961,1,1,1704294660,1704294663,1704294699,36,COMPLETED
5315962,1,1,1704294660,1704294663,1704294700,37,COMPLETED
5315963,1,1,1704294660,1704294663,1704294698,35,COMPLETED
5315964,1,1,1704294660,1704294663,1704294700,37,COMPLETED
5315965,1,1,1704294660,1704294663,1704294701,38,COMPLETED
5315966,1,1,1704294660,1704294663,1704294699,36,COMPLETED
5315967,1,1,1704294660,1704294663,1704294700,37,COMPLETED
5315968,1,1,1704294660,1704294663,1704294699,36,COMPLETED
5315969,1,1,1704294660,1704294663,1704294699,36,COMPLETED
5315970,1,1,1704294660,1704294663,1704294702,39,COMPLETED
5315971,1,1,1704294660,1704294663,1704294698,35,COMPLETED
5315972,1,1,1704294660,1704294663,1704294698,35,COMPLETED
5315973,1,1,1704294660,1704294663,1704294700,37,COMPLETED
5315974,1,1,1704294660,1704294663,1704294700,37,COMPLETED
5315975,1,1,1704294660,1704294663,1704294700,37,COMPLETED
5315976,1,1,1704294660,1704294663,1704294700,37,COMPLETED
5315977,1,1,1704294660,1704294663,1704294730,67,COMPLETED
5315978,1,1,1704294661,1704294663,1704294729,66,COMPLETED
5315979,1,1,1704294661,1704294663,1704294727,64,COMPLETED
5315980,1,1,1704294661,1704294663,1704294729,66,COMPLETED
5315981,1,1,1704294661,1704294663,1704294735,72,COMPLETED
5315982,1,1,1704294661,1704294663,1704294728,65,COMPLETED
5315983,1,1,1704294661,1704294663,1704294729,66,COMPLETED
5315984,1,1,1704294661,1704294663,1704294729,66,COMPLETED
5315985,1,1,1704294661,1704294663,1704294730,67,COMPLETED
5315986,1,1,1704294661,1704294663,1704294729,66,COMPLETED
5315987,1,1,1704294661,1704294663,1704294729,66,COMPLETED
5315988,1,1,1704294661,1704294663,1704294729,66,COMPLETED
5315990,1,1,1704294661,1704294663,1704294728,65,COMPLETED
5315991,1,1,1704294661,1704294663,1704294730,67,COMPLETED
5315992,1,1,1704294661,1704294663,1704294729,66,COMPLETED
5315993,1,1,1704294661,1704294663,1704294729,66,COMPLETED
5315994,1,1,1704294661,1704294663,1704294729,66,COMPLETED
5315995,1,1,1704294661,1704294663,1704294730,67,COMPLETED
5315996,1,1,1704294661,1704294663,1704294730,67,COMPLETED
5315997,1,1,1704294661,1704294663,1704294730,67,COMPLETED
5315998,1,1,1704294661,1704294663,1704294730,67,COMPLETED
5315999,1,1,1704294661,1704294663,1704294727,64,COMPLETED
5316000,1,1,1704294661,1704294663,1704294728,65,COMPLETED
5316001,1,1,1704294661,1704294663,1704294727,64,COMPLETED
5316002,1,1,1704294661,1704294663,1704294728,65,COMPLETED
5316003,1,1,1704294661,1704294663,1704294729,66,COMPLETED
5316004,1,1,1704294661,1704294663,1704294729,66,COMPLETED
5316005,1,1,1704294661,1704294663,1704294728,65,COMPLETED
5316006,1,1,1704294661,1704294663,1704294730,67,COMPLETED
5316007,1,1,1704294661,1704294663,1704294727,64,COMPLETED
5316008,1,1,1704294661,1704294663,1704294729,66,COMPLETED
5316009,1,1,1704294661,1704294663,1704294727,64,COMPLETED
5316010,1,1,1704294661,1704294663,1704294735,72,COMPLETED
5316011,1,1,1704294661,1704294663,1704294730,67,COMPLETED
5316012,1,1,1704294661,1704294663,1704294735,72,COMPLETED
5316013,1,1,1704294661,1704294663,1704294698,35,COMPLETED
5316014,1,1,1704294661,1704294663,1704294701,38,COMPLETED
5316015,1,1,1704294661,1704294663,1704294698,35,COMPLETED
5316016,1,1,1704294661,1704294663,1704294699,36,COMPLETED
5315989,1,1,1704294661,1704294663,1704294788,125,COMPLETED
5316017,1,1,1704294662,1704294663,1704294701,38,COMPLETED
5316018,1,1,1704294662,1704294663,1704294699,36,COMPLETED
5316019,1,1,1704294662,1704294663,1704294698,35,COMPLETED
5316020,1,1,1704294662,1704294663,1704294701,38,COMPLETED
5316021,1,1,1704294662,1704294663,1704294699,36,COMPLETED
5316022,1,1,1704294662,1704294663,1704294701,38,COMPLETED
5316023,1,1,1704294662,1704294663,1704294699,36,COMPLETED
5316024,1,1,1704294662,1704294663,1704294702,39,COMPLETED
5316025,1,1,1704294662,1704294663,1704294699,36,COMPLETED
5316026,1,1,1704294662,1704294663,1704294698,35,COMPLETED
5316027,1,1,1704294662,1704294663,1704294698,35,COMPLETED
5316028,1,1,1704294662,1704294663,1704294698,35,COMPLETED
5316029,1,1,1704294662,1704294663,1704294701,38,COMPLETED
5316030,1,1,1704294662,1704294663,1704294698,35,COMPLETED
5316031,1,1,1704294662,1704294663,1704294698,35,COMPLETED
5316032,1,1,1704294662,1704294663,1704294709,46,COMPLETED
5316033,1,1,1704294662,1704294663,1704294698,35,COMPLETED
5316034,1,1,1704294662,1704294663,1704294699,36,COMPLETED
5316035,1,1,1704294662,1704294663,1704294699,36,COMPLETED
5316036,1,1,1704294662,1704294663,1704294701,38,COMPLETED
5316037,1,1,1704294662,1704294663,1704294699,36,COMPLETED
5316038,1,1,1704294662,1704294663,1704294705,42,COMPLETED
5316039,1,1,1704294662,1704294663,1704294703,40,COMPLETED
5316040,1,1,1704294662,1704294663,1704294702,39,COMPLETED
5316041,1,1,1704294662,1704294663,1704294698,35,COMPLETED
5316042,1,1,1704294663,1704294663,1704294702,39,COMPLETED
5316043,1,1,1704294663,1704294663,1704294699,36,COMPLETED
5316044,1,1,1704294663,1704294663,1704294701,38,COMPLETED
5316045,1,1,1704294663,1704294663,1704294698,35,COMPLETED
5316046,1,1,1704294663,1704294663,1704294698,35,COMPLETED
5316047,1,1,1704294663,1704294663,1704294701,38,COMPLETED
5316048,1,1,1704294663,1704294663,1704294698,35,COMPLETED
5316049,1,1,1704294663,1704294663,1704294690,27,COMPLETED
5316050,1,1,1704294663,1704294663,1704294691,28,COMPLETED
5316051,1,1,1704294663,1704294663,1704294698,35,COMPLETED
5316052,1,1,1704294663,1704294663,1704294690,27,COMPLETED
5316053,1,1,1704294663,1704294663,1704294690,27,COMPLETED
5316054,1,1,1704294663,1704294663,1704294690,27,COMPLETED
5316055,1,1,1704294663,1704294663,1704294690,27,COMPLETED
5316056,1,1,1704294663,1704294663,1704294690,27,COMPLETED
5316057,1,1,1704294663,1704294663,1704294690,27,COMPLETED
5316058,1,1,1704294663,1704294663,1704294698,35,COMPLETED
5316059,1,1,1704294663,1704294663,1704294690,27,COMPLETED
5316060,1,1,1704294663,1704294663,1704294690,27,COMPLETED
5316061,1,1,1704294663,1704294663,1704294690,27,COMPLETED
5316062,1,1,1704294663,1704294667,1704294727,60,COMPLETED
5316063,1,1,1704294663,1704294667,1704294724,57,COMPLETED
5316064,1,1,1704294663,1704294667,1704294723,56,COMPLETED
5316065,1,1,1704294664,1704294667,1704294725,58,COMPLETED
5316066,1,1,1704294664,1704294667,1704294727,60,COMPLETED
5316067,1,1,1704294664,1704294667,1704294728,61,COMPLETED
5316068,1,1,1704294664,1704294667,1704294724,57,COMPLETED
5316069,1,1,1704294664,1704294667,1704294725,58,COMPLETED
5316070,1,1,1704294664,1704294667,1704294727,60,COMPLETED
5316071,1,1,1704294664,1704294667,1704294723,56,COMPLETED
5316072,1,1,1704294664,1704294667,1704294724,57,COMPLETED
5316073,1,1,1704294664,1704294667,1704294726,59,COMPLETED
5316074,1,1,1704294664,1704294667,1704294723,56,COMPLETED
5316075,1,1,1704294664,1704294667,1704294724,57,COMPLETED
5316076,1,1,1704294664,1704294667,1704294726,59,COMPLETED
5316077,1,1,1704294664,1704294667,1704294727,60,COMPLETED
5316078,1,1,1704294664,1704294667,1704294723,56,COMPLETED
5316079,1,1,1704294664,1704294667,1704294725,58,COMPLETED
5316080,1,1,1704294664,1704294667,1704294724,57,COMPLETED
5316081,1,1,1704294665,1704294667,1704294726,59,COMPLETED
5316082,1,1,1704294665,1704294667,1704294724,57,COMPLETED
5316083,1,1,1704294665,1704294667,1704294725,58,COMPLETED
5316084,1,1,1704294665,1704294667,1704294724,57,COMPLETED
5316085,1,1,1704294665,1704294667,1704294723,56,COMPLETED
5316086,1,1,1704294665,1704294667,1704294723,56,COMPLETED
5316087,1,1,1704294665,1704294667,1704294723,56,COMPLETED
5316088,1,1,1704294665,1704294667,1704294723,56,COMPLETED
5316089,1,1,1704294665,1704294667,1704294726,59,COMPLETED
5316090,1,1,1704294665,1704294667,1704294723,56,COMPLETED
5316091,1,1,1704294665,1704294667,1704294723,56,COMPLETED
5316092,1,1,1704294665,1704294667,1704294724,57,COMPLETED
5316093,1,1,1704294665,1704294667,1704294723,56,COMPLETED
5316094,1,1,1704294665,1704294667,1704294723,56,COMPLETED
5316095,1,1,1704294665,1704294667,1704294724,57,COMPLETED
5316096,1,1,1704294665,1704294667,1704294723,56,COMPLETED
5316097,1,1,1704294665,1704294667,1704294725,58,COMPLETED
5316098,1,1,1704294665,1704294667,1704294723,56,COMPLETED
5316099,1,1,1704294665,1704294667,1704294727,60,COMPLETED
5316100,1,1,1704294665,1704294667,1704294723,56,COMPLETED
5316101,1,1,1704294665,1704294667,1704294723,56,COMPLETED
5316102,1,1,1704294665,1704294667,1704294724,57,COMPLETED
5316103,1,1,1704294665,1704294667,1704294723,56,COMPLETED
5316104,1,1,1704294665,1704294667,1704294723,56,COMPLETED
5316105,1,1,1704294699,1704294699,1704294747,48,COMPLETED
5316106,1,1,1704294700,1704294700,1704294750,50,COMPLETED
5316107,1,1,1704294700,1704294700,1704294745,45,COMPLETED
5316108,1,1,1704294700,1704294700,1704294746,46,COMPLETED
5316109,1,1,1704294700,1704294700,1704294746,46,COMPLETED
5316110,1,1,1704294700,1704294700,1704294746,46,COMPLETED
5316111,1,1,1704294700,1704294700,1704294745,45,COMPLETED
5316112,1,1,1704294701,1704294701,1704294746,45,COMPLETED
5316113,1,1,1704294701,1704294701,1704294745,44,COMPLETED
5316114,1,1,1704294701,1704294701,1704294744,43,COMPLETED
5316115,1,1,1704294701,1704294701,1704294746,45,COMPLETED
5316116,1,1,1704294701,1704294702,1704294753,51,COMPLETED
5316117,1,1,1704294702,1704294702,1704294745,43,COMPLETED
5316118,1,1,1704294702,1704294702,1704294747,45,COMPLETED
5316119,1,1,1704294702,1704294702,1704294745,43,COMPLETED
5316120,1,1,1704294702,1704294702,1704294749,47,COMPLETED
5316121,1,1,1704294702,1704294702,1704294745,43,COMPLETED
5316122,1,1,1704294702,1704294702,1704294747,45,COMPLETED
5316123,1,1,1704294702,1704294702,1704294749,47,COMPLETED
5316124,1,1,1704294702,1704294702,1704294756,54,COMPLETED
5316125,1,1,1704294705,1704294707,1704294754,47,COMPLETED
5316126,1,1,1704294705,1704294707,1704294755,48,COMPLETED
5316127,1,1,1704294706,1704294707,1704294756,49,COMPLETED
5316128,1,1,1704294706,1704294707,1704294756,49,COMPLETED
5316129,1,1,1704294707,1704294707,1704294756,49,COMPLETED
5316130,1,1,1704294707,1704294707,1704294755,48,COMPLETED
5316131,1,1,1704294707,1704294707,1704294753,46,COMPLETED
5316132,1,1,1704294707,1704294708,1704294753,45,COMPLETED
5316133,1,1,1704294707,1704294708,1704294754,46,COMPLETED
5316134,1,1,1704294707,1704294708,1704294756,48,COMPLETED
5316135,1,1,1704294707,1704294708,1704294753,45,COMPLETED
5316136,1,1,1704294707,1704294708,1704294755,47,COMPLETED
5316137,1,1,1704294707,1704294708,1704294755,47,COMPLETED
5316138,1,1,1704294707,1704294708,1704294757,49,COMPLETED
5316139,1,1,1704294707,1704294708,1704294753,45,COMPLETED
5316140,1,1,1704294708,1704294708,1704294755,47,COMPLETED
5316141,1,1,1704294708,1704294708,1704294755,47,COMPLETED
5316142,1,1,1704294708,1704294708,1704294756,48,COMPLETED
5316143,1,1,1704294708,1704294708,1704294756,48,COMPLETED
5316144,1,1,1704294708,1704294708,1704294755,47,COMPLETED
5316145,1,1,1704294708,1704294708,1704294755,47,COMPLETED
5316146,1,1,1704294708,1704294708,1704294756,48,COMPLETED
5316147,1,1,1704294708,1704294710,1704294757,47,COMPLETED
5316148,1,1,1704294709,1704294710,1704294752,42,COMPLETED
5316149,1,1,1704294709,1704294710,1704294756,46,COMPLETED
5316150,1,1,1704294709,1704294710,1704294755,45,COMPLETED
5316151,1,1,1704294709,1704294710,1704294753,43,COMPLETED
5316152,1,1,1704294709,1704294710,1704294755,45,COMPLETED
5316153,1,1,1704294709,1704294710,1704294754,44,COMPLETED
5316154,1,1,1704294709,1704294710,1704294756,46,COMPLETED
5316155,1,1,1704294709,1704294710,1704294757,47,COMPLETED
5316156,1,1,1704294709,1704294710,1704294753,43,COMPLETED
5316157,1,1,1704294709,1704294710,1704294753,43,COMPLETED
5316158,1,1,1704294710,1704294710,1704294755,45,COMPLETED
5316159,1,1,1704294710,1704294710,1704294754,44,COMPLETED
5316160,1,1,1704294710,1704294710,1704294747,37,COMPLETED
5316161,1,1,1704294710,1704294710,1704294749,39,COMPLETED
5316162,1,1,1704294710,1704294710,1704294747,37,COMPLETED
5316163,1,1,1704294710,1704294710,1704294746,36,COMPLETED
5316164,1,1,1704294710,1704294710,1704294747,37,COMPLETED
5316165,1,1,1704294710,1704294710,1704294749,39,COMPLETED
5316166,1,1,1704294710,1704294710,1704294747,37,COMPLETED
5316167,1,1,1704294710,1704294710,1704294747,37,COMPLETED
5316168,1,1,1704294711,1704294712,1704294747,35,COMPLETED
5316169,1,1,1704294711,1704294712,1704294746,34,COMPLETED
5316170,1,1,1704294711,1704294712,1704294755,43,COMPLETED
5316171,1,1,1704294711,1704294712,1704294744,32,COMPLETED
5316172,1,1,1704294711,1704294712,1704294744,32,COMPLETED
5316173,1,1,1704294731,1704294731,1704294779,48,COMPLETED
5316174,1,1,1704294731,1704294731,1704294780,49,COMPLETED
5316175,1,1,1704294732,1704294735,1704294780,45,COMPLETED
5316176,1,1,1704294732,1704294735,1704294780,45,COMPLETED
5316177,1,1,1704294732,1704294735,1704294780,45,COMPLETED
5316178,1,1,1704294732,1704294735,1704294779,44,COMPLETED
5316179,1,1,1704294732,1704294735,1704294779,44,COMPLETED
5316180,1,1,1704294732,1704294735,1704294779,44,COMPLETED
5316181,1,1,1704294732,1704294735,1704294779,44,COMPLETED
5316182,1,1,1704294732,1704294735,1704294778,43,COMPLETED
5316183,1,1,1704294732,1704294735,1704294780,45,COMPLETED
5316184,1,1,1704294732,1704294735,1704294778,43,COMPLETED
5316185,1,1,1704294733,1704294735,1704294778,43,COMPLETED
5316186,1,1,1704294733,1704294735,1704294779,44,COMPLETED
5316187,1,1,1704294733,1704294735,1704294778,43,COMPLETED
5316188,1,1,1704294733,1704294735,1704294780,45,COMPLETED
5316189,1,1,1704294733,1704294735,1704294778,43,COMPLETED
5316190,1,1,1704294733,1704294735,1704294781,46,COMPLETED
5316191,1,1,1704294733,1704294735,1704294780,45,COMPLETED
5316192,1,1,1704294733,1704294735,1704294779,44,COMPLETED
5316193,1,1,1704294733,1704294735,1704294779,44,COMPLETED
5316194,1,1,1704294733,1704294735,1704294780,45,COMPLETED
5316195,1,1,1704294734,1704294735,1704294783,48,COMPLETED
5316196,1,1,1704294734,1704294735,1704294779,44,COMPLETED
5316197,1,1,1704294734,1704294735,1704294780,45,COMPLETED
5316198,1,1,1704294734,1704294735,1704294778,43,COMPLETED
5316199,1,1,1704294734,1704294735,1704294779,44,COMPLETED
5316200,1,1,1704294734,1704294735,1704294780,45,COMPLETED
5316201,1,1,1704294734,1704294735,1704294780,45,COMPLETED
5316202,1,1,1704294734,1704294735,1704294779,44,COMPLETED
5316203,1,1,1704294735,1704294735,1704294779,44,COMPLETED
5316204,1,1,1704294735,1704294735,1704294778,43,COMPLETED
5316205,1,1,1704294735,1704294735,1704294780,45,COMPLETED
5316206,1,1,1704294735,1704294735,1704294773,38,COMPLETED
5316207,1,1,1704294735,1704294735,1704294774,39,COMPLETED
5316208,1,1,1704294735,1704294735,1704294773,38,COMPLETED
5316209,1,1,1704294735,1704294735,1704294773,38,COMPLETED
5316210,1,1,1704294735,1704294735,1704294773,38,COMPLETED
5316211,1,1,1704294736,1704294736,1704294774,38,COMPLETED
5316212,1,1,1704294736,1704294736,1704294774,38,COMPLETED
5316213,1,1,1704294736,1704294736,1704294780,44,COMPLETED
5316214,1,1,1704294736,1704294736,1704294773,37,COMPLETED
5316215,1,1,1704294736,1704294736,1704294773,37,COMPLETED
5316216,1,1,1704294736,1704294736,1704294774,38,COMPLETED
5316217,1,1,1704294736,1704294736,1704294775,39,COMPLETED
5316218,1,1,1704294736,1704294736,1704294773,37,COMPLETED
5316219,1,1,1704294736,1704294736,1704294775,39,COMPLETED
5316220,1,1,1704294736,1704294736,1704294780,44,COMPLETED
5316221,1,1,1704294736,1704294736,1704294774,38,COMPLETED
5316222,1,1,1704294736,1704294737,1704294773,36,COMPLETED
5316223,1,1,1704294736,1704294737,1704294773,36,COMPLETED
5316224,1,1,1704294736,1704294737,1704294773,36,COMPLETED
5316225,1,1,1704294737,1704294739,1704294773,34,COMPLETED
5316226,1,1,1704294737,1704294739,1704294773,34,COMPLETED
5316227,1,1,1704294737,1704294739,1704294773,34,COMPLETED
5316228,1,1,1704294737,1704294739,1704294773,34,COMPLETED
5316229,1,1,1704294809,1704294810,1704294859,49,COMPLETED
5316230,1,1,1704294809,1704294810,1704294863,53,COMPLETED
5316231,1,1,1704294809,1704294810,1704294860,50,COMPLETED
5316232,1,1,1704294809,1704294810,1704294860,50,COMPLETED
5316233,1,1,1704294809,1704294810,1704294860,50,COMPLETED
5316234,1,1,1704294809,1704294810,1704294862,52,COMPLETED
5316235,1,1,1704294809,1704294810,1704294861,51,COMPLETED
5316236,1,1,1704294809,1704294810,1704294859,49,COMPLETED
5316237,1,1,1704294809,1704294810,1704294860,50,COMPLETED
5316238,1,1,1704294809,1704294810,1704294859,49,COMPLETED
5316239,1,1,1704294809,1704294810,1704294859,49,COMPLETED
5316240,1,1,1704294809,1704294810,1704294859,49,COMPLETED
5316241,1,1,1704294809,1704294810,1704294860,50,COMPLETED
5316242,1,1,1704294809,1704294810,1704294862,52,COMPLETED
5316243,1,1,1704294809,1704294810,1704294859,49,COMPLETED
5316244,1,1,1704294809,1704294810,1704294860,50,COMPLETED
5316245,1,1,1704294809,1704294810,1704294859,49,COMPLETED
5316246,1,1,1704294810,1704294810,1704294860,50,COMPLETED
5316247,1,1,1704294810,1704294810,1704294862,52,COMPLETED
5316248,1,1,1704294810,1704294810,1704294859,49,COMPLETED
5316249,1,1,1704294810,1704294814,1704294860,46,COMPLETED
5316250,1,1,1704294810,1704294814,1704294860,46,COMPLETED
5316251,1,1,1704294810,1704294814,1704294860,46,COMPLETED
5316252,1,1,1704294810,1704294814,1704294860,46,COMPLETED
5316253,1,1,1704294810,1704294814,1704294864,50,COMPLETED
5316254,1,1,1704294810,1704294814,1704294860,46,COMPLETED
5316255,1,1,1704294810,1704294814,1704294859,45,COMPLETED
5316256,1,1,1704294810,1704294814,1704294859,45,COMPLETED
5316257,1,1,1704294810,1704294814,1704294863,49,COMPLETED
5316258,1,1,1704294810,1704294814,1704294859,45,COMPLETED
5316259,1,1,1704294810,1704294814,1704294860,46,COMPLETED
5316260,1,1,1704294810,1704294814,1704294863,49,COMPLETED
5316261,1,1,1704294810,1704294814,1704294864,50,COMPLETED
5316262,1,1,1704294810,1704294814,1704294862,48,COMPLETED
5316263,1,1,1704294810,1704294814,1704294863,49,COMPLETED
5316264,1,1,1704294810,1704294814,1704294859,45,COMPLETED
5316265,1,1,1704294810,1704294814,1704294860,46,COMPLETED
5316266,1,1,1704294810,1704294814,1704294859,45,COMPLETED
5316267,1,1,1704294810,1704294814,1704294861,47,COMPLETED
5316268,1,1,1704294810,1704294814,1704294861,47,COMPLETED
5316269,1,1,1704294810,1704294814,1704294859,45,COMPLETED
5316270,1,1,1704294810,1704294814,1704294861,47,COMPLETED
5316271,1,1,1704294810,1704294814,1704294859,45,COMPLETED
5316272,1,1,1704294810,1704294814,1704294859,45,COMPLETED
5316273,1,1,1704294810,1704294814,1704294863,49,COMPLETED
5316274,1,1,1704294810,1704294814,1704294860,46,COMPLETED
5316275,1,1,1704294810,1704294814,1704294859,45,COMPLETED
5316276,1,1,1704294810,1704294814,1704294859,45,COMPLETED
5316277,1,1,1704294810,1704294814,1704294859,45,COMPLETED
5316278,1,1,1704294811,1704294814,1704294861,47,COMPLETED
5316279,1,1,1704294811,1704294814,1704294862,48,COMPLETED
5316280,1,1,1704294811,1704294814,1704294859,45,COMPLETED
5316281,1,1,1704294811,1704294814,1704294860,46,COMPLETED
5316282,1,1,1704294811,1704294814,1704294859,45,COMPLETED
5316283,1,1,1704294811,1704294814,1704294859,45,COMPLETED
5316284,1,1,1704294811,1704294814,1704294859,45,COMPLETED
5316285,1,1,1704294811,1704294814,1704294860,46,COMPLETED
5316286,1,1,1704294811,1704294814,1704294859,45,COMPLETED
5316287,1,1,1704294811,1704294814,1704294860,46,COMPLETED
5316288,1,1,1704294811,1704294814,1704294864,50,COMPLETED
5316289,1,1,1704294811,1704294814,1704294859,45,COMPLETED
5316290,1,1,1704294811,1704294814,1704294861,47,COMPLETED
5316291,1,1,1704294811,1704294814,1704294861,47,COMPLETED
5316292,1,1,1704294811,1704294814,1704294861,47,COMPLETED
5316293,1,1,1704294811,1704294814,1704294859,45,COMPLETED
5316294,1,1,1704294811,1704294814,1704294864,50,COMPLETED
5316295,1,1,1704294811,1704294814,1704294860,46,COMPLETED
5316296,1,1,1704294811,1704294814,1704294859,45,COMPLETED
5316297,1,1,1704294811,1704294814,1704294859,45,COMPLETED
5316298,1,1,1704294811,1704294814,1704294859,45,COMPLETED
5316299,1,1,1704294811,1704294814,1704294863,49,COMPLETED
5316300,1,1,1704294811,1704294814,1704294859,45,COMPLETED
5316301,1,1,1704294811,1704294814,1704294859,45,COMPLETED
5316302,1,1,1704294811,1704294814,1704294860,46,COMPLETED
5316303,1,1,1704294811,1704294814,1704294859,45,COMPLETED
5316304,1,1,1704294811,1704294814,1704294864,50,COMPLETED
5316305,1,1,1704294811,1704294814,1704294859,45,COMPLETED
5316306,1,1,1704294811,1704294814,1704294862,48,COMPLETED
5316307,1,1,1704294811,1704294814,1704294862,48,COMPLETED
5316308,1,1,1704294811,1704294814,1704294860,46,COMPLETED
5316309,1,1,1704294811,1704294814,1704294861,47,COMPLETED
5316310,1,1,1704294811,1704294814,1704294860,46,COMPLETED
5316311,1,1,1704294812,1704294814,1704294859,45,COMPLETED
5316312,1,1,1704294812,1704294814,1704294860,46,COMPLETED
5316313,1,1,1704294812,1704294814,1704294859,45,COMPLETED
5316314,1,1,1704294812,1704294814,1704294860,46,COMPLETED
5316315,1,1,1704294812,1704294814,1704294859,45,COMPLETED
5316316,1,1,1704294812,1704294814,1704294861,47,COMPLETED
5316317,1,1,1704294812,1704294814,1704294859,45,COMPLETED
5316318,1,1,1704294812,1704294814,1704294859,45,COMPLETED
5316319,1,1,1704294812,1704294814,1704294864,50,COMPLETED
5316320,1,1,1704294812,1704294814,1704294860,46,COMPLETED
5316321,1,1,1704294812,1704294814,1704294860,46,COMPLETED
5316322,1,1,1704294812,1704294814,1704294859,45,COMPLETED
5316323,1,1,1704294812,1704294814,1704294865,51,COMPLETED
5316324,1,1,1704294812,1704294814,1704294859,45,COMPLETED
5316325,1,1,1704294812,1704294814,1704294859,45,COMPLETED
5316326,1,1,1704294812,1704294814,1704294861,47,COMPLETED
5316327,1,1,1704294812,1704294814,1704294860,46,COMPLETED
5316328,1,1,1704294812,1704294814,1704294860,46,COMPLETED
5316329,1,1,1704294812,1704294814,1704294860,46,COMPLETED
5316330,1,1,1704294812,1704294814,1704294863,49,COMPLETED
5316331,1,1,1704294812,1704294814,1704294864,50,COMPLETED
5316332,1,1,1704294812,1704294814,1704294859,45,COMPLETED
5316333,1,1,1704294812,1704294814,1704294862,48,COMPLETED
5316334,1,1,1704294812,1704294814,1704294863,49,COMPLETED
5316335,1,1,1704294812,1704294814,1704294859,45,COMPLETED
5316336,1,1,1704294812,1704294814,1704294859,45,COMPLETED
5316337,1,1,1704294812,1704294814,1704294859,45,COMPLETED
5316338,1,1,1704294813,1704294814,1704294860,46,COMPLETED
5316339,1,1,1704294813,1704294814,1704294860,46,COMPLETED
5316340,1,1,1704294813,1704294814,1704294860,46,COMPLETED
5316341,1,1,1704294813,1704294814,1704294859,45,COMPLETED
5316342,1,1,1704294813,1704294814,1704294859,45,COMPLETED
5316343,1,1,1704294813,1704294814,1704294859,45,COMPLETED
5316344,1,1,1704294813,1704294814,1704294863,49,COMPLETED
5316345,1,1,1704294813,1704294814,1704294863,49,COMPLETED
5316346,1,1,1704294813,1704294814,1704294864,50,COMPLETED
5316347,1,1,1704294813,1704294814,1704294859,45,COMPLETED
5316348,1,1,1704294813,1704294814,1704294863,49,COMPLETED
5316349,1,1,1704294813,1704294814,1704294860,46,COMPLETED
5316350,1,1,1704294813,1704294814,1704294861,47,COMPLETED
5316351,1,1,1704294813,1704294814,1704294861,47,COMPLETED
5316352,1,1,1704294813,1704294814,1704294863,49,COMPLETED
5316353,1,1,1704294813,1704294814,1704294859,45,COMPLETED
5316354,1,1,1704294813,1704294814,1704294860,46,COMPLETED
5316355,1,1,1704294813,1704294814,1704294859,45,COMPLETED
5316356,1,1,1704294813,1704294814,1704294859,45,COMPLETED
5316357,1,1,1704294813,1704294814,1704294860,46,COMPLETED
5316358,1,1,1704294813,1704294814,1704294863,49,COMPLETED
5316359,1,1,1704294813,1704294814,1704294864,50,COMPLETED
5316360,1,1,1704294813,1704294814,1704294863,49,COMPLETED
5316361,1,1,1704294813,1704294814,1704294864,50,COMPLETED
5316362,1,1,1704294813,1704294814,1704294861,47,COMPLETED
5316363,1,1,1704294813,1704294814,1704294859,45,COMPLETED
5316364,1,1,1704294813,1704294814,1704294860,46,COMPLETED
5316365,1,1,1704294813,1704294814,1704294861,47,COMPLETED
5316366,1,1,1704294813,1704294814,1704294859,45,COMPLETED
5316367,1,1,1704294813,1704294814,1704294863,49,COMPLETED
5316368,1,1,1704294813,1704294814,1704294860,46,COMPLETED
5316369,1,1,1704294814,1704294818,1704294859,41,COMPLETED
5316370,1,1,1704294814,1704294818,1704294860,42,COMPLETED
5316371,1,1,1704294814,1704294818,1704294861,43,COMPLETED
5316372,1,1,1704294814,1704294818,1704294863,45,COMPLETED
5316373,1,1,1704294815,1704294818,1704294864,46,COMPLETED
5316374,1,1,1704294815,1704294818,1704294860,42,COMPLETED
5316375,1,1,1704294815,1704294818,1704294860,42,COMPLETED
5316376,1,1,1704294815,1704294818,1704294860,42,COMPLETED
5316377,1,1,1704294815,1704294818,1704294864,46,COMPLETED
5316378,1,1,1704294816,1704294818,1704294860,42,COMPLETED
5316379,1,1,1704294816,1704294818,1704294861,43,COMPLETED
5316380,1,1,1704294816,1704294818,1704294860,42,COMPLETED
5316381,1,1,1704294816,1704294818,1704294861,43,COMPLETED
5316382,1,1,1704294816,1704294818,1704294860,42,COMPLETED
5316383,1,1,1704294816,1704294818,1704294859,41,COMPLETED
5316384,1,1,1704294816,1704294818,1704294862,44,COMPLETED
5316385,1,1,1704294816,1704294818,1704294860,42,COMPLETED
5316386,1,1,1704294816,1704294818,1704294859,41,COMPLETED
5316387,1,1,1704294816,1704294818,1704294864,46,COMPLETED
5316388,1,1,1704294816,1704294818,1704294864,46,COMPLETED
5316389,1,1,1704294816,1704294818,1704294860,42,COMPLETED
5316390,1,1,1704294816,1704294818,1704294864,46,COMPLETED
5316391,1,1,1704294816,1704294818,1704294860,42,COMPLETED
5316393,1,1,1704294816,1704294818,1704294860,42,COMPLETED
5316394,1,1,1704294816,1704294818,1704294862,44,COMPLETED
5316395,1,1,1704294816,1704294818,1704294860,42,COMPLETED
5316396,1,1,1704294816,1704294818,1704294860,42,COMPLETED
5316397,1,1,1704294816,1704294818,1704294860,42,COMPLETED
5316398,1,1,1704294816,1704294818,1704294862,44,COMPLETED
5316399,1,1,1704294816,1704294818,1704294860,42,COMPLETED
5316400,1,1,1704294816,1704294818,1704294860,42,COMPLETED
5316401,1,1,1704294816,1704294818,1704294860,42,COMPLETED
5316402,1,1,1704294816,1704294818,1704294860,42,COMPLETED
5316403,1,1,1704294816,1704294818,1704294860,42,COMPLETED
5316404,1,1,1704294816,1704294818,1704294859,41,COMPLETED
5316405,1,1,1704294816,1704294818,1704294860,42,COMPLETED
5316406,1,1,1704294816,1704294818,1704294859,41,COMPLETED
5316407,1,1,1704294816,1704294818,1704294860,42,COMPLETED
5316408,1,1,1704294816,1704294818,1704294860,42,COMPLETED
5316409,1,1,1704294816,1704294818,1704294859,41,COMPLETED
5316392,1,1,1704294816,1704294818,1704294945,127,COMPLETED
5316410,1,1,1704294817,1704294818,1704294859,41,COMPLETED
5316411,1,1,1704294817,1704294818,1704294859,41,COMPLETED
5316412,1,1,1704294817,1704294818,1704294860,42,COMPLETED
5316413,1,1,1704294817,1704294818,1704294859,41,COMPLETED
5316414,1,1,1704294817,1704294818,1704294859,41,COMPLETED
5316415,1,1,1704294817,1704294818,1704294859,41,COMPLETED
5316416,1,1,1704294817,1704294818,1704294860,42,COMPLETED
5316417,1,1,1704294817,1704294818,1704294859,41,COMPLETED
5316418,1,1,1704294817,1704294818,1704294860,42,COMPLETED
5316419,1,1,1704294817,1704294818,1704294860,42,COMPLETED
5316420,1,1,1704294817,1704294818,1704294859,41,COMPLETED
5316421,1,1,1704294817,1704294818,1704294860,42,COMPLETED
5316422,1,1,1704294817,1704294818,1704294860,42,COMPLETED
5316423,1,1,1704294817,1704294818,1704294859,41,COMPLETED
5316424,1,1,1704294817,1704294818,1704294860,42,COMPLETED
5316425,1,1,1704294817,1704294818,1704294860,42,COMPLETED
5316426,1,1,1704294817,1704294818,1704294860,42,COMPLETED
5316427,1,1,1704294817,1704294818,1704294859,41,COMPLETED
5316428,1,1,1704294817,1704294818,1704294859,41,COMPLETED
5316429,1,1,1704294861,1704294861,1704294889,28,COMPLETED
5316430,1,1,1704294861,1704294861,1704294889,28,COMPLETED
5316431,1,1,1704294861,1704294861,1704294889,28,COMPLETED
5316432,1,1,1704294861,1704294861,1704294889,28,COMPLETED
5316433,1,1,1704294861,1704294861,1704294889,28,COMPLETED
5316434,1,1,1704294861,1704294861,1704294889,28,COMPLETED
5316435,1,1,1704294862,1704294862,1704294889,27,COMPLETED
5316436,1,1,1704294862,1704294862,1704294889,27,COMPLETED
5316437,1,1,1704294862,1704294862,1704294889,27,COMPLETED
5316438,1,1,1704294862,1704294862,1704294889,27,COMPLETED
5316439,1,1,1704294862,1704294862,1704294889,27,COMPLETED
5316440,1,1,1704294863,1704294863,1704294892,29,COMPLETED
5316441,1,1,1704294863,1704294863,1704294889,26,COMPLETED
5316442,1,1,1704294863,1704294863,1704294889,26,COMPLETED
5316443,1,1,1704294863,1704294863,1704294889,26,COMPLETED
5316444,1,1,1704294863,1704294863,1704294889,26,COMPLETED
5316445,1,1,1704294863,1704294863,1704294893,30,COMPLETED
5316446,1,1,1704294863,1704294863,1704294889,26,COMPLETED
5316447,1,1,1704294863,1704294863,1704294889,26,COMPLETED
5316448,1,1,1704294863,1704294863,1704294889,26,COMPLETED
5316449,1,1,1704294863,1704294863,1704294893,30,COMPLETED
5316450,1,1,1704294874,1704294874,1704294904,30,COMPLETED
5316451,1,1,1704294874,1704294874,1704294904,30,COMPLETED
5316452,1,1,1704294874,1704294874,1704294904,30,COMPLETED
5316453,1,1,1704294874,1704294874,1704294904,30,COMPLETED
5316454,1,1,1704294874,1704294874,1704294904,30,COMPLETED
5316455,1,1,1704294874,1704294874,1704294904,30,COMPLETED
5316456,1,1,1704294874,1704294878,1704294925,47,COMPLETED
5316457,1,1,1704294874,1704294878,1704294923,45,COMPLETED
5316458,1,1,1704294874,1704294878,1704294921,43,COMPLETED
5316459,1,1,1704294875,1704294878,1704294919,41,COMPLETED
5316460,1,1,1704294875,1704294878,1704294919,41,COMPLETED
5316461,1,1,1704294875,1704294878,1704294922,44,COMPLETED
5316462,1,1,1704294875,1704294878,1704294920,42,COMPLETED
5316463,1,1,1704294875,1704294878,1704294922,44,COMPLETED
5316464,1,1,1704294875,1704294878,1704294922,44,COMPLETED
5316465,1,1,1704294875,1704294878,1704294920,42,COMPLETED
5316466,1,1,1704294875,1704294878,1704294919,41,COMPLETED
5316467,1,1,1704294875,1704294878,1704294920,42,COMPLETED
5316468,1,1,1704294875,1704294878,1704294924,46,COMPLETED
5316469,1,1,1704294876,1704294878,1704294920,42,COMPLETED
5316470,1,1,1704294876,1704294878,1704294920,42,COMPLETED
5316471,1,1,1704294876,1704294878,1704294922,44,COMPLETED
5316472,1,1,1704294876,1704294878,1704294922,44,COMPLETED
5316473,1,1,1704294876,1704294878,1704294922,44,COMPLETED
5316474,1,1,1704294876,1704294878,1704294920,42,COMPLETED
5316475,1,1,1704294876,1704294878,1704294919,41,COMPLETED
5316476,1,1,1704294876,1704294878,1704294919,41,COMPLETED
5316477,1,1,1704294876,1704294878,1704294919,41,COMPLETED
5316478,1,1,1704294876,1704294878,1704294922,44,COMPLETED
5316479,1,1,1704294877,1704294878,1704294920,42,COMPLETED
5316480,1,1,1704294877,1704294878,1704294922,44,COMPLETED
5316481,1,1,1704294877,1704294878,1704294921,43,COMPLETED
5316482,1,1,1704294877,1704294878,1704294922,44,COMPLETED
5316483,1,1,1704294877,1704294878,1704294919,41,COMPLETED
5316484,1,1,1704294877,1704294878,1704294922,44,COMPLETED
5316485,1,1,1704294877,1704294878,1704294924,46,COMPLETED
5316486,1,1,1704294877,1704294878,1704294921,43,COMPLETED
5316487,1,1,1704294877,1704294878,1704294921,43,COMPLETED
5316488,1,1,1704294877,1704294878,1704294921,43,COMPLETED
5316489,1,1,1704294878,1704294878,1704294919,41,COMPLETED
5316490,1,1,1704294878,1704294878,1704294921,43,COMPLETED
5316491,1,1,1704294878,1704294878,1704294921,43,COMPLETED
5316492,1,1,1704294878,1704294882,1704294925,43,COMPLETED
5316493,1,1,1704294878,1704294882,1704294921,39,COMPLETED
5316494,1,1,1704294878,1704294882,1704294922,40,COMPLETED
5316495,1,1,1704294878,1704294882,1704294920,38,COMPLETED
5316496,1,1,1704294879,1704294882,1704294926,44,COMPLETED
5316497,1,1,1704294879,1704294882,1704294922,40,COMPLETED
5316498,1,1,1704294879,1704294882,1704294922,40,COMPLETED
5316499,1,1,1704294879,1704294882,1704294921,39,COMPLETED
5316500,1,1,1704294880,1704294882,1704294921,39,COMPLETED
5316501,1,1,1704294880,1704294882,1704294921,39,COMPLETED
5316502,1,1,1704294880,1704294882,1704294920,38,COMPLETED
5316503,1,1,1704294880,1704294882,1704294922,40,COMPLETED
5316504,1,1,1704294880,1704294882,1704294919,37,COMPLETED
5316505,1,1,1704294880,1704294882,1704294921,39,COMPLETED
5316506,1,1,1704294880,1704294882,1704294919,37,COMPLETED
5316507,1,1,1704294880,1704294882,1704294920,38,COMPLETED
5316508,1,1,1704294880,1704294882,1704294934,52,COMPLETED
5316509,1,1,1704294881,1704294882,1704294919,37,COMPLETED
5316510,1,1,1704294881,1704294882,1704294925,43,COMPLETED
5316511,1,1,1704294881,1704294882,1704294921,39,COMPLETED
5316512,1,1,1704294881,1704294882,1704294921,39,COMPLETED
5316513,1,1,1704294881,1704294882,1704294925,43,COMPLETED
5316514,1,1,1704294881,1704294882,1704294923,41,COMPLETED
5316515,1,1,1704294881,1704294882,1704294920,38,COMPLETED
5316516,1,1,1704294881,1704294882,1704294920,38,COMPLETED
5316517,1,1,1704294881,1704294882,1704294919,37,COMPLETED
5316518,1,1,1704294881,1704294882,1704294919,37,COMPLETED
5316519,1,1,1704294881,1704294882,1704294925,43,COMPLETED
5316520,1,1,1704294881,1704294882,1704294921,39,COMPLETED
5316521,1,1,1704294882,1704294882,1704294919,37,COMPLETED
5316522,1,1,1704294882,1704294882,1704294919,37,COMPLETED
5316523,1,1,1704294882,1704294882,1704294919,37,COMPLETED
5316524,1,1,1704294882,1704294882,1704294919,37,COMPLETED
5316525,1,1,1704294882,1704294882,1704294919,37,COMPLETED
5316526,1,1,1704294882,1704294886,1704294919,33,COMPLETED
5316527,1,1,1704294882,1704294886,1704294919,33,COMPLETED
5316528,1,1,1704294882,1704294886,1704294919,33,COMPLETED
5316529,1,1,1704294883,1704294886,1704294919,33,COMPLETED
5316530,1,1,1704294883,1704294886,1704294919,33,COMPLETED
5316531,1,1,1704294883,1704294886,1704294919,33,COMPLETED
5316532,1,1,1704294883,1704294886,1704294920,34,COMPLETED
5316533,1,1,1704294883,1704294886,1704294919,33,COMPLETED
5316534,1,1,1704294883,1704294886,1704294919,33,COMPLETED
5316535,1,1,1704294883,1704294886,1704294919,33,COMPLETED
5316536,1,1,1704294883,1704294886,1704294919,33,COMPLETED
5316537,1,1,1704294883,1704294886,1704294919,33,COMPLETED
5316538,1,1,1704294883,1704294886,1704294919,33,COMPLETED
5316539,1,1,1704294883,1704294886,1704294919,33,COMPLETED
5316540,1,1,1704294883,1704294886,1704294919,33,COMPLETED
5316541,1,1,1704294883,1704294886,1704294919,33,COMPLETED
5316542,1,1,1704294883,1704294886,1704294919,33,COMPLETED
5316543,1,1,1704294884,1704294886,1704294919,33,COMPLETED
5316544,1,1,1704294884,1704294886,1704294919,33,COMPLETED
5316545,1,1,1704294884,1704294886,1704294919,33,COMPLETED
5316546,1,1,1704294884,1704294886,1704294919,33,COMPLETED
5316547,1,1,1704294884,1704294886,1704294920,34,COMPLETED
5316548,1,1,1704294884,1704294886,1704294919,33,COMPLETED
5316549,1,1,1704294884,1704294886,1704294919,33,COMPLETED
5316550,1,1,1704294884,1704294886,1704294919,33,COMPLETED
5316551,1,1,1704294884,1704294886,1704294919,33,COMPLETED
5316552,1,1,1704294884,1704294886,1704294919,33,COMPLETED
5316553,1,1,1704294884,1704294886,1704294919,33,COMPLETED
5316554,1,1,1704294884,1704294886,1704294919,33,COMPLETED
5316555,1,1,1704294884,1704294886,1704294919,33,COMPLETED
5316556,1,1,1704294884,1704294886,1704294920,34,COMPLETED
5316557,1,1,1704294884,1704294886,1704294923,37,COMPLETED
5316558,1,1,1704294884,1704294886,1704294919,33,COMPLETED
5316559,1,1,1704294885,1704294886,1704294919,33,COMPLETED
5316560,1,1,1704294885,1704294886,1704294919,33,COMPLETED
5316561,1,1,1704294885,1704294886,1704294921,35,COMPLETED
5316562,1,1,1704294885,1704294886,1704294919,33,COMPLETED
5316563,1,1,1704294885,1704294886,1704294919,33,COMPLETED
5316564,1,1,1704294885,1704294886,1704294919,33,COMPLETED
5316565,1,1,1704294885,1704294886,1704294925,39,COMPLETED
5316566,1,1,1704294885,1704294886,1704294919,33,COMPLETED
5316567,1,1,1704294885,1704294886,1704294924,38,COMPLETED
5316568,1,1,1704294885,1704294886,1704294919,33,COMPLETED
5316569,1,1,1704294886,1704294886,1704294919,33,COMPLETED
5316570,1,1,1704294886,1704294890,1704294938,48,COMPLETED
5316571,1,1,1704294886,1704294890,1704294938,48,COMPLETED
5316572,1,1,1704294886,1704294890,1704294938,48,COMPLETED
5316573,1,1,1704294887,1704294890,1704294938,48,COMPLETED
5316574,1,1,1704294887,1704294890,1704294938,48,COMPLETED
5316575,1,1,1704294887,1704294890,1704294938,48,COMPLETED
5316576,1,1,1704294887,1704294890,1704294938,48,COMPLETED
5316577,1,1,1704294887,1704294890,1704294938,48,COMPLETED
5316578,1,1,1704294887,1704294890,1704294938,48,COMPLETED
5316579,1,1,1704294887,1704294890,1704294938,48,COMPLETED
5316580,1,1,1704294887,1704294890,1704294938,48,COMPLETED
5316581,1,1,1704294887,1704294890,1704294938,48,COMPLETED
5316582,1,1,1704294887,1704294890,1704294938,48,COMPLETED
5316583,1,1,1704294887,1704294890,1704294938,48,COMPLETED
5316584,1,1,1704294887,1704294890,1704294938,48,COMPLETED
5316585,1,1,1704294887,1704294890,1704294938,48,COMPLETED
5316586,1,1,1704294887,1704294890,1704294938,48,COMPLETED
5316587,1,1,1704294887,1704294890,1704294938,48,COMPLETED
5316589,1,1,1704294965,1704294965,1704295017,52,COMPLETED
5316590,1,1,1704294965,1704294965,1704295019,54,COMPLETED
5316591,1,1,1704294965,1704294970,1704295016,46,COMPLETED
5316592,1,1,1704294966,1704294970,1704295016,46,COMPLETED
5316593,1,1,1704294966,1704294970,1704295018,48,COMPLETED
5316594,1,1,1704294966,1704294970,1704295016,46,COMPLETED
5316595,1,1,1704294966,1704294970,1704295016,46,COMPLETED
5316596,1,1,1704294966,1704294970,1704295018,48,COMPLETED
5316597,1,1,1704294966,1704294970,1704295018,48,COMPLETED
5316598,1,1,1704294966,1704294970,1704295018,48,COMPLETED
5316599,1,1,1704294966,1704294970,1704295016,46,COMPLETED
5316600,1,1,1704294966,1704294970,1704295016,46,COMPLETED
5316601,1,1,1704294966,1704294970,1704295016,46,COMPLETED
5316602,1,1,1704294967,1704294970,1704295019,49,COMPLETED
5316603,1,1,1704294967,1704294970,1704295016,46,COMPLETED
5316604,1,1,1704294967,1704294970,1704295019,49,COMPLETED
5316605,1,1,1704294967,1704294970,1704295019,49,COMPLETED
5316606,1,1,1704294967,1704294970,1704295016,46,COMPLETED
5316607,1,1,1704294967,1704294970,1704295016,46,COMPLETED
5316608,1,1,1704294967,1704294970,1704295017,47,COMPLETED
5316609,1,1,1704294967,1704294970,1704295019,49,COMPLETED
5316610,1,1,1704294967,1704294970,1704295016,46,COMPLETED
5316611,1,1,1704294967,1704294970,1704295016,46,COMPLETED
5316612,1,1,1704294967,1704294970,1704295018,48,COMPLETED
5316613,1,1,1704294967,1704294970,1704295019,49,COMPLETED
5316614,1,1,1704294967,1704294970,1704295016,46,COMPLETED
5316615,1,1,1704294967,1704294970,1704295016,46,COMPLETED
5316616,1,1,1704294967,1704294970,1704295019,49,COMPLETED
5316617,1,1,1704294967,1704294970,1704295018,48,COMPLETED
5316618,1,1,1704294967,1704294970,1704295019,49,COMPLETED
5316619,1,1,1704294967,1704294970,1704295016,46,COMPLETED
5316620,1,1,1704294967,1704294970,1704295019,49,COMPLETED
5316621,1,1,1704294967,1704294970,1704295018,48,COMPLETED
5316622,1,1,1704294967,1704294970,1704295016,46,COMPLETED
5316623,1,1,1704294967,1704294970,1704295018,48,COMPLETED
5316624,1,1,1704294967,1704294970,1704295018,48,COMPLETED
5316625,1,1,1704294968,1704294970,1704295018,48,COMPLETED
5316626,1,1,1704294968,1704294970,1704295016,46,COMPLETED
5316627,1,1,1704294968,1704294970,1704295020,50,COMPLETED
5316628,1,1,1704294968,1704294970,1704295016,46,COMPLETED
5316629,1,1,1704294968,1704294970,1704295017,47,COMPLETED
5316630,1,1,1704294968,1704294970,1704295016,46,COMPLETED
5316631,1,1,1704294968,1704294970,1704295023,53,COMPLETED
5316632,1,1,1704294968,1704294970,1704295016,46,COMPLETED
5316633,1,1,1704294968,1704294970,1704295019,49,COMPLETED
5316634,1,1,1704294968,1704294970,1704295017,47,COMPLETED
5316635,1,1,1704294968,1704294970,1704295016,46,COMPLETED
5316636,1,1,1704294968,1704294970,1704295021,51,COMPLETED
5316637,1,1,1704294968,1704294970,1704295016,46,COMPLETED
5316638,1,1,1704294968,1704294970,1704295018,48,COMPLETED
5316639,1,1,1704294968,1704294970,1704295016,46,COMPLETED
5316640,1,1,1704294968,1704294970,1704295016,46,COMPLETED
5316641,1,1,1704294969,1704294970,1704295017,47,COMPLETED
5316642,1,1,1704294969,1704294970,1704295018,48,COMPLETED
5316643,1,1,1704294969,1704294970,1704295017,47,COMPLETED
5316644,1,1,1704294969,1704294970,1704295018,48,COMPLETED
5316645,1,1,1704294969,1704294970,1704295017,47,COMPLETED
5316646,1,1,1704294969,1704294970,1704295017,47,COMPLETED
5316647,1,1,1704294969,1704294970,1704295016,46,COMPLETED
5316648,1,1,1704294969,1704294970,1704295017,47,COMPLETED
5316649,1,1,1704294970,1704294974,1704295018,44,COMPLETED
5316650,1,1,1704294970,1704294974,1704295016,42,COMPLETED
5316651,1,1,1704294970,1704294974,1704295018,44,COMPLETED
5316652,1,1,1704294970,1704294974,1704295017,43,COMPLETED
5316653,1,1,1704294970,1704294974,1704295016,42,COMPLETED
5316654,1,1,1704294970,1704294974,1704295018,44,COMPLETED
5316655,1,1,1704294970,1704294974,1704295018,44,COMPLETED
5316656,1,1,1704294971,1704294974,1704295018,44,COMPLETED
5316657,1,1,1704294971,1704294974,1704295017,43,COMPLETED
5316658,1,1,1704294971,1704294974,1704295016,42,COMPLETED
5316659,1,1,1704294971,1704294974,1704295018,44,COMPLETED
5316660,1,1,1704294971,1704294974,1704295018,44,COMPLETED
5316661,1,1,1704294971,1704294974,1704295017,43,COMPLETED
5316662,1,1,1704294971,1704294974,1704295018,44,COMPLETED
5316663,1,1,1704294971,1704294974,1704295017,43,COMPLETED
5316664,1,1,1704294971,1704294974,1704295019,45,COMPLETED
5316665,1,1,1704294971,1704294974,1704295018,44,COMPLETED
5316666,1,1,1704294971,1704294974,1704295017,43,COMPLETED
5316667,1,1,1704294971,1704294974,1704295016,42,COMPLETED
5316668,1,1,1704294972,1704294974,1704295016,42,COMPLETED
5316669,1,1,1704294972,1704294974,1704295019,45,COMPLETED
5316670,1,1,1704294972,1704294974,1704295016,42,COMPLETED
5316671,1,1,1704294972,1704294974,1704295019,45,COMPLETED
5316672,1,1,1704294972,1704294974,1704295016,42,COMPLETED
5316673,1,1,1704294972,1704294974,1704295017,43,COMPLETED
5316674,1,1,1704294972,1704294974,1704295017,43,COMPLETED
5316675,1,1,1704294972,1704294974,1704295016,42,COMPLETED
5316676,1,1,1704294972,1704294974,1704295018,44,COMPLETED
5316677,1,1,1704294972,1704294974,1704295018,44,COMPLETED
5316678,1,1,1704294972,1704294974,1704295019,45,COMPLETED
5316679,1,1,1704294972,1704294974,1704295019,45,COMPLETED
5316680,1,1,1704294972,1704294974,1704295017,43,COMPLETED
5316681,1,1,1704294972,1704294974,1704295018,44,COMPLETED
5316682,1,1,1704294972,1704294974,1704295017,43,COMPLETED
5316683,1,1,1704294972,1704294974,1704295017,43,COMPLETED
5316684,1,1,1704294972,1704294974,1704295016,42,COMPLETED
5316685,1,1,1704294972,1704294974,1704295017,43,COMPLETED
5316686,1,1,1704294972,1704294974,1704295017,43,COMPLETED
5316687,1,1,1704294972,1704294974,1704295017,43,COMPLETED
5316688,1,1,1704294972,1704294974,1704295016,42,COMPLETED
5316689,1,1,1704294972,1704294974,1704295018,44,COMPLETED
5316690,1,1,1704294972,1704294974,1704295021,47,COMPLETED
5316691,1,1,1704294972,1704294974,1704295017,43,COMPLETED
5316692,1,1,1704294972,1704294974,1704295019,45,COMPLETED
5316693,1,1,1704294973,1704294974,1704295017,43,COMPLETED
5316694,1,1,1704294973,1704294974,1704295020,46,COMPLETED
5316695,1,1,1704294973,1704294974,1704295019,45,COMPLETED
5316696,1,1,1704294973,1704294974,1704295017,43,COMPLETED
5316697,1,1,1704294973,1704294974,1704295016,42,COMPLETED
5316698,1,1,1704294973,1704294974,1704295016,42,COMPLETED
5316699,1,1,1704294973,1704294974,1704295016,42,COMPLETED
5316700,1,1,1704294973,1704294974,1704295016,42,COMPLETED
5316701,1,1,1704294973,1704294974,1704295016,42,COMPLETED
5316702,1,1,1704294973,1704294974,1704295016,42,COMPLETED
5316703,1,1,1704294973,1704294974,1704295016,42,COMPLETED
5316704,1,1,1704294973,1704294974,1704295016,42,COMPLETED
5316705,1,1,1704294973,1704294974,1704295017,43,COMPLETED
5316706,1,1,1704294974,1704294974,1704295016,42,COMPLETED
5316707,1,1,1704294974,1704294978,1704295019,41,COMPLETED
5316708,1,1,1704294974,1704294978,1704295019,41,COMPLETED
5316709,1,1,1704294974,1704294978,1704295025,47,COMPLETED
5316710,1,1,1704294974,1704294978,1704295021,43,COMPLETED
5316711,1,1,1704294974,1704294978,1704295017,39,COMPLETED
5316712,1,1,1704294974,1704294978,1704295021,43,COMPLETED
5316713,1,1,1704294974,1704294978,1704295021,43,COMPLETED
5316714,1,1,1704294974,1704294978,1704295024,46,COMPLETED
5316715,1,1,1704294974,1704294978,1704295022,44,COMPLETED
5316716,1,1,1704294975,1704294978,1704295029,51,COMPLETED
5316717,1,1,1704294975,1704294978,1704295024,46,COMPLETED
5316718,1,1,1704294975,1704294978,1704295017,39,COMPLETED
5316719,1,1,1704294975,1704294978,1704295021,43,COMPLETED
5316720,1,1,1704294975,1704294978,1704295022,44,COMPLETED
5316721,1,1,1704294975,1704294978,1704295022,44,COMPLETED
5316722,1,1,1704294975,1704294978,1704295021,43,COMPLETED
5316723,1,1,1704294975,1704294978,1704295021,43,COMPLETED
5316724,1,1,1704294976,1704294978,1704295022,44,COMPLETED
5316725,1,1,1704294976,1704294978,1704295022,44,COMPLETED
5316726,1,1,1704294976,1704294978,1704295019,41,COMPLETED
5316727,1,1,1704294976,1704294978,1704295020,42,COMPLETED
5316728,1,1,1704294976,1704294978,1704295021,43,COMPLETED
5316729,1,1,1704294976,1704294978,1704295021,43,COMPLETED
5316730,1,1,1704294976,1704294978,1704295022,44,COMPLETED
5316731,1,1,1704294976,1704294978,1704295021,43,COMPLETED
5316732,1,1,1704294976,1704294978,1704295022,44,COMPLETED
5316733,1,1,1704294976,1704294978,1704295020,42,COMPLETED
5316734,1,1,1704294976,1704294978,1704295021,43,COMPLETED
5316735,1,1,1704294976,1704294978,1704295022,44,COMPLETED
5316736,1,1,1704294976,1704294978,1704295020,42,COMPLETED
5316737,1,1,1704294976,1704294978,1704295018,40,COMPLETED
5316738,1,1,1704294976,1704294978,1704295020,42,COMPLETED
5316739,1,1,1704294976,1704294978,1704295022,44,COMPLETED
5316740,1,1,1704294976,1704294978,1704295021,43,COMPLETED
5316741,1,1,1704294977,1704294978,1704295020,42,COMPLETED
5316742,1,1,1704294977,1704294978,1704295020,42,COMPLETED
5316743,1,1,1704294977,1704294978,1704295018,40,COMPLETED
5316744,1,1,1704294977,1704294978,1704295020,42,COMPLETED
5316745,1,1,1704294977,1704294978,1704295021,43,COMPLETED
5316746,1,1,1704294977,1704294978,1704295016,38,COMPLETED
5316747,1,1,1704294977,1704294978,1704295021,43,COMPLETED
5316748,1,1,1704294977,1704294978,1704295018,40,COMPLETED
5316749,1,1,1704294977,1704294978,1704295022,44,COMPLETED
5316750,1,1,1704294977,1704294978,1704295019,41,COMPLETED
5316751,1,1,1704294977,1704294978,1704295018,40,COMPLETED
5316752,1,1,1704294977,1704294978,1704295019,41,COMPLETED
5316753,1,1,1704294977,1704294978,1704295022,44,COMPLETED
5316754,1,1,1704294977,1704294978,1704295021,43,COMPLETED
5316755,1,1,1704294977,1704294978,1704295020,42,COMPLETED
5316756,1,1,1704294977,1704294978,1704295020,42,COMPLETED
5316757,1,1,1704294978,1704294978,1704295021,43,COMPLETED
5316758,1,1,1704294978,1704294978,1704295019,41,COMPLETED
5316759,1,1,1704294978,1704294978,1704295020,42,COMPLETED
5316760,1,1,1704294978,1704294978,1704295020,42,COMPLETED
5316761,1,1,1704294978,1704294978,1704295018,40,COMPLETED
5316762,1,1,1704294978,1704294978,1704295021,43,COMPLETED
5316763,1,1,1704294978,1704294982,1704295035,53,COMPLETED
5316764,1,1,1704294978,1704294982,1704295035,53,COMPLETED
5316765,1,1,1704294978,1704294982,1704295035,53,COMPLETED
5316766,1,1,1704294978,1704294982,1704295035,53,COMPLETED
5316767,1,1,1704294978,1704294982,1704295035,53,COMPLETED
5316768,1,1,1704294979,1704294982,1704295035,53,COMPLETED
5316769,1,1,1704294979,1704294982,1704295044,62,COMPLETED
5316770,1,1,1704294979,1704294982,1704295046,64,COMPLETED
5316771,1,1,1704294979,1704294982,1704295045,63,COMPLETED
5316772,1,1,1704294979,1704294982,1704295046,64,COMPLETED
5316773,1,1,1704294979,1704294982,1704295043,61,COMPLETED
5316774,1,1,1704294979,1704294982,1704295045,63,COMPLETED
5316775,1,1,1704294979,1704294982,1704295044,62,COMPLETED
5316776,1,1,1704294979,1704294982,1704295046,64,COMPLETED
5316777,1,1,1704294979,1704294982,1704295055,73,COMPLETED
5316778,1,1,1704294980,1704294982,1704295046,64,COMPLETED
5316779,1,1,1704294980,1704294982,1704295043,61,COMPLETED
5316780,1,1,1704294980,1704294982,1704295046,64,COMPLETED
5316781,1,1,1704294980,1704294982,1704295043,61,COMPLETED
5316782,1,1,1704294980,1704294982,1704295046,64,COMPLETED
5316783,1,1,1704294980,1704294982,1704295043,61,COMPLETED
5316784,1,1,1704294980,1704294982,1704295045,63,COMPLETED
5316785,1,1,1704294980,1704294982,1704295061,79,COMPLETED
5316786,1,1,1704294980,1704294982,1704295046,64,COMPLETED
5316787,1,1,1704294980,1704294982,1704295043,61,COMPLETED
5316788,1,1,1704294980,1704294982,1704295043,61,COMPLETED
5316789,1,1,1704295021,1704295021,1704295061,40,COMPLETED
5316790,1,1,1704295021,1704295021,1704295058,37,COMPLETED
5316791,1,1,1704295021,1704295021,1704295061,40,COMPLETED
5316792,1,1,1704295021,1704295021,1704295058,37,COMPLETED
5316793,1,1,1704295021,1704295021,1704295061,40,COMPLETED
5316794,1,1,1704295021,1704295021,1704295061,40,COMPLETED
5316795,1,1,1704295021,1704295021,1704295058,37,COMPLETED
5316796,1,1,1704295021,1704295021,1704295065,44,COMPLETED
5316797,1,1,1704295021,1704295021,1704295058,37,COMPLETED
5316798,1,1,1704295022,1704295022,1704295058,36,COMPLETED
5316799,1,1,1704295022,1704295022,1704295061,39,COMPLETED
5316800,1,1,1704295022,1704295022,1704295061,39,COMPLETED
5316801,1,1,1704295022,1704295022,1704295062,40,COMPLETED
5316802,1,1,1704295022,1704295022,1704295061,39,COMPLETED
5316803,1,1,1704295022,1704295022,1704295062,40,COMPLETED
5316804,1,1,1704295022,1704295022,1704295061,39,COMPLETED
5316805,1,1,1704295022,1704295022,1704295061,39,COMPLETED
5316806,1,1,1704295023,1704295023,1704295054,31,COMPLETED
5316807,1,1,1704295023,1704295023,1704295054,31,COMPLETED
5316808,1,1,1704295023,1704295023,1704295054,31,COMPLETED
5316809,1,1,1704295023,1704295023,1704295054,31,COMPLETED
5316810,1,1,1704295023,1704295023,1704295054,31,COMPLETED
5316811,1,1,1704295023,1704295023,1704295055,32,COMPLETED
5316812,1,1,1704295023,1704295023,1704295054,31,COMPLETED
5316813,1,1,1704295023,1704295023,1704295054,31,COMPLETED
5316814,1,1,1704295023,1704295023,1704295055,32,COMPLETED
5316815,1,1,1704295023,1704295023,1704295054,31,COMPLETED
5316816,1,1,1704295023,1704295023,1704295055,32,COMPLETED
5316817,1,1,1704295024,1704295024,1704295056,32,COMPLETED
5316818,1,1,1704295024,1704295024,1704295055,31,COMPLETED
5316819,1,1,1704295024,1704295024,1704295057,33,COMPLETED
5316820,1,1,1704295024,1704295024,1704295055,31,COMPLETED
5316821,1,1,1704295024,1704295024,1704295056,32,COMPLETED
5316822,1,1,1704295024,1704295024,1704295054,30,COMPLETED
5316823,1,1,1704295024,1704295024,1704295055,31,COMPLETED
5316824,1,1,1704295025,1704295025,1704295064,39,COMPLETED
5316825,1,1,1704295025,1704295025,1704295063,38,COMPLETED
5316826,1,1,1704295025,1704295025,1704295064,39,COMPLETED
5316827,1,1,1704295025,1704295025,1704295065,40,COMPLETED
5316828,1,1,1704295025,1704295025,1704295067,42,COMPLETED
5316829,1,1,1704295025,1704295025,1704295065,40,COMPLETED
5316830,1,1,1704295025,1704295025,1704295066,41,COMPLETED
5316831,1,1,1704295025,1704295025,1704295064,39,COMPLETED
5316832,1,1,1704295025,1704295025,1704295065,40,COMPLETED
5316833,1,1,1704295025,1704295025,1704295065,40,COMPLETED
5316834,1,1,1704295026,1704295026,1704295063,37,COMPLETED
5316835,1,1,1704295026,1704295026,1704295065,39,COMPLETED
5316836,1,1,1704295026,1704295026,1704295065,39,COMPLETED
5316837,1,1,1704295026,1704295026,1704295065,39,COMPLETED
5316838,1,1,1704295026,1704295029,1704295066,37,COMPLETED
5316839,1,1,1704295026,1704295029,1704295066,37,COMPLETED
5316840,1,1,1704295026,1704295029,1704295063,34,COMPLETED
5316841,1,1,1704295026,1704295029,1704295066,37,COMPLETED
5316842,1,1,1704295026,1704295029,1704295065,36,COMPLETED
5316843,1,1,1704295026,1704295029,1704295065,36,COMPLETED
5316844,1,1,1704295027,1704295029,1704295065,36,COMPLETED
5316845,1,1,1704295027,1704295029,1704295065,36,COMPLETED
5316846,1,1,1704295027,1704295029,1704295065,36,COMPLETED
5316847,1,1,1704295027,1704295029,1704295065,36,COMPLETED
5316848,1,1,1704295027,1704295029,1704295065,36,COMPLETED
5316849,1,1,1704295027,1704295029,1704295065,36,COMPLETED
5316850,1,1,1704295027,1704295029,1704295063,34,COMPLETED
5316851,1,1,1704295027,1704295029,1704295065,36,COMPLETED
5316852,1,1,1704295027,1704295029,1704295065,36,COMPLETED
5316853,1,1,1704295027,1704295029,1704295064,35,COMPLETED
5316854,1,1,1704295028,1704295029,1704295066,37,COMPLETED
5316855,1,1,1704295028,1704295029,1704295065,36,COMPLETED
5316856,1,1,1704295028,1704295029,1704295065,36,COMPLETED
5316857,1,1,1704295028,1704295029,1704295063,34,COMPLETED
5316858,1,1,1704295028,1704295029,1704295065,36,COMPLETED
5316859,1,1,1704295028,1704295029,1704295054,25,COMPLETED
5316860,1,1,1704295028,1704295029,1704295055,26,COMPLETED
5316861,1,1,1704295028,1704295029,1704295055,26,COMPLETED
5316862,1,1,1704295028,1704295029,1704295056,27,COMPLETED
5316863,1,1,1704295028,1704295029,1704295054,25,COMPLETED
5316864,1,1,1704295031,1704295033,1704295072,39,COMPLETED
5316865,1,1,1704295031,1704295033,1704295072,39,COMPLETED
5316866,1,1,1704295031,1704295033,1704295073,40,COMPLETED
5316867,1,1,1704295031,1704295033,1704295071,38,COMPLETED
5316868,1,1,1704295032,1704295033,1704295074,41,COMPLETED
5316869,1,1,1704295032,1704295033,1704295072,39,COMPLETED
5316870,1,1,1704295032,1704295033,1704295072,39,COMPLETED
5316871,1,1,1704295032,1704295033,1704295072,39,COMPLETED
5316872,1,1,1704295032,1704295033,1704295071,38,COMPLETED
5316873,1,1,1704295032,1704295033,1704295071,38,COMPLETED
5316874,1,1,1704295032,1704295033,1704295072,39,COMPLETED
5316875,1,1,1704295032,1704295033,1704295071,38,COMPLETED
5316876,1,1,1704295032,1704295033,1704295072,39,COMPLETED
5316877,1,1,1704295032,1704295033,1704295072,39,COMPLETED
5316878,1,1,1704295033,1704295033,1704295072,39,COMPLETED
5316879,1,1,1704295033,1704295033,1704295071,38,COMPLETED
5316880,1,1,1704295033,1704295033,1704295071,38,COMPLETED
5316881,1,1,1704295033,1704295033,1704295071,38,COMPLETED
5316882,1,1,1704295033,1704295033,1704295066,33,COMPLETED
5316883,1,1,1704295033,1704295033,1704295063,30,COMPLETED
5316884,1,1,1704295033,1704295033,1704295064,31,COMPLETED
5316885,1,1,1704295033,1704295033,1704295065,32,COMPLETED
5316886,1,1,1704295033,1704295033,1704295064,31,COMPLETED
5316887,1,1,1704295033,1704295033,1704295063,30,COMPLETED
5316888,1,1,1704295034,1704295036,1704295089,53,COMPLETED
5316889,1,1,1704295034,1704295036,1704295089,53,COMPLETED
5316890,1,1,1704295034,1704295036,1704295091,55,COMPLETED
5316891,1,1,1704295034,1704295036,1704295092,56,COMPLETED
5316892,1,1,1704295034,1704295036,1704295088,52,COMPLETED
5316893,1,1,1704295034,1704295036,1704295089,53,COMPLETED
5316894,1,1,1704295034,1704295036,1704295087,51,COMPLETED
5316895,1,1,1704295034,1704295036,1704295091,55,COMPLETED
5316896,1,1,1704295034,1704295036,1704295086,50,COMPLETED
5316897,1,1,1704295034,1704295036,1704295088,52,COMPLETED
5316898,1,1,1704295035,1704295036,1704295088,52,COMPLETED
5316900,1,1,1704295035,1704295036,1704295088,52,COMPLETED
5316901,1,1,1704295035,1704295036,1704295088,52,COMPLETED
5316902,1,1,1704295035,1704295036,1704295087,51,COMPLETED
5316903,1,1,1704295035,1704295036,1704295088,52,COMPLETED
5316904,1,1,1704295035,1704295036,1704295086,50,COMPLETED
5316905,1,1,1704295035,1704295036,1704295088,52,COMPLETED
5316906,1,1,1704295035,1704295036,1704295086,50,COMPLETED
5316907,1,1,1704295035,1704295036,1704295095,59,COMPLETED
5316899,1,1,1704295035,1704295036,1704295263,227,COMPLETED
5316908,1,1,1704295036,1704295036,1704295097,61,COMPLETED
5316909,1,1,1704295036,1704295036,1704295094,58,COMPLETED
5316910,1,1,1704295036,1704295036,1704295095,59,COMPLETED
5316911,1,1,1704295036,1704295036,1704295096,60,COMPLETED
5316912,1,1,1704295036,1704295036,1704295097,61,COMPLETED
5316913,1,1,1704295036,1704295036,1704295096,60,COMPLETED
5316914,1,1,1704295036,1704295036,1704295100,64,COMPLETED
5316915,1,1,1704295036,1704295036,1704295093,57,COMPLETED
5316916,1,1,1704295037,1704295037,1704295094,57,COMPLETED
5316917,1,1,1704295037,1704295037,1704295092,55,COMPLETED
5316918,1,1,1704295037,1704295037,1704295096,59,COMPLETED
5316919,1,1,1704295037,1704295037,1704295095,58,COMPLETED
5316920,1,1,1704295037,1704295037,1704295092,55,COMPLETED
5316921,1,1,1704295037,1704295037,1704295096,59,COMPLETED
5316922,1,1,1704295037,1704295037,1704295095,58,COMPLETED
5316923,1,1,1704295037,1704295037,1704295092,55,COMPLETED
5316924,1,1,1704295037,1704295041,1704295095,54,COMPLETED
5316925,1,1,1704295038,1704295041,1704295092,51,COMPLETED
5316926,1,1,1704295038,1704295041,1704295093,52,COMPLETED
5316927,1,1,1704295038,1704295041,1704295096,55,COMPLETED
5316928,1,1,1704295038,1704295041,1704295096,55,COMPLETED
5316929,1,1,1704295038,1704295041,1704295091,50,COMPLETED
5316930,1,1,1704295038,1704295041,1704295094,53,COMPLETED
5316931,1,1,1704295038,1704295041,1704295091,50,COMPLETED
5316932,1,1,1704295038,1704295041,1704295094,53,COMPLETED
5316933,1,1,1704295038,1704295041,1704295097,56,COMPLETED
5316934,1,1,1704295038,1704295041,1704295100,59,COMPLETED
5316935,1,1,1704295038,1704295041,1704295096,55,COMPLETED
5316936,1,1,1704295038,1704295041,1704295095,54,COMPLETED
5316937,1,1,1704295038,1704295041,1704295096,55,COMPLETED
5316938,1,1,1704295039,1704295041,1704295097,56,COMPLETED
5316939,1,1,1704295039,1704295041,1704295095,54,COMPLETED
5316940,1,1,1704295039,1704295041,1704295093,52,COMPLETED
5316941,1,1,1704295039,1704295041,1704295094,53,COMPLETED
5316942,1,1,1704295039,1704295041,1704295096,55,COMPLETED
5316943,1,1,1704295039,1704295041,1704295081,40,COMPLETED
5316944,1,1,1704295040,1704295041,1704295081,40,COMPLETED
5316945,1,1,1704295040,1704295041,1704295081,40,COMPLETED
5316946,1,1,1704295040,1704295041,1704295083,42,COMPLETED
5316947,1,1,1704295040,1704295041,1704295081,40,COMPLETED
5316948,1,1,1704295040,1704295041,1704295081,40,COMPLETED
5316949,1,1,1704295040,1704295041,1704295082,41,COMPLETED
5316950,1,1,1704295041,1704295041,1704295082,41,COMPLETED
5316951,1,1,1704295041,1704295041,1704295083,42,COMPLETED
5316952,1,1,1704295041,1704295041,1704295081,40,COMPLETED
5316953,1,1,1704295041,1704295041,1704295082,41,COMPLETED
5316954,1,1,1704295041,1704295041,1704295091,50,COMPLETED
5316955,1,1,1704295041,1704295041,1704295081,40,COMPLETED
5316956,1,1,1704295041,1704295041,1704295081,40,COMPLETED
5316957,1,1,1704295041,1704295041,1704295083,42,COMPLETED
5316959,1,1,1704295057,1704295057,1704295099,42,COMPLETED
5316960,1,1,1704295057,1704295057,1704295101,44,COMPLETED
5316961,1,1,1704295057,1704295057,1704295100,43,COMPLETED
5316962,1,1,1704295057,1704295057,1704295099,42,COMPLETED
5316963,1,1,1704295057,1704295057,1704295100,43,COMPLETED
5316965,1,1,1704295065,1704295065,1704295108,43,COMPLETED
5316966,1,1,1704295065,1704295065,1704295110,45,COMPLETED
5316967,1,1,1704295065,1704295065,1704295108,43,COMPLETED
5316968,1,1,1704295065,1704295065,1704295111,46,COMPLETED
5316969,1,1,1704295066,1704295066,1704295110,44,COMPLETED
5316970,1,1,1704295066,1704295066,1704295110,44,COMPLETED
5316971,1,1,1704295066,1704295066,1704295111,45,COMPLETED
5316972,1,1,1704295066,1704295066,1704295108,42,COMPLETED
5316973,1,1,1704295066,1704295066,1704295109,43,COMPLETED
5316974,1,1,1704295066,1704295066,1704295114,48,COMPLETED
5316975,1,1,1704295066,1704295066,1704295112,46,COMPLETED
5316976,1,1,1704295066,1704295066,1704295131,65,COMPLETED
5316977,1,1,1704295066,1704295066,1704295109,43,COMPLETED
5316978,1,1,1704295066,1704295067,1704295110,43,COMPLETED
5316979,1,1,1704295067,1704295067,1704295111,44,COMPLETED
5316980,1,1,1704295067,1704295067,1704295108,41,COMPLETED
5316981,1,1,1704295067,1704295068,1704295124,56,COMPLETED
5316982,1,1,1704295067,1704295068,1704295137,69,COMPLETED
5316983,1,1,1704295067,1704295068,1704295110,42,COMPLETED
5316984,1,1,1704295067,1704295068,1704295111,43,COMPLETED
5316985,1,1,1704295067,1704295068,1704295109,41,COMPLETED
5316986,1,1,1704295068,1704295068,1704295112,44,COMPLETED
5316987,1,1,1704295068,1704295068,1704295111,43,COMPLETED
5316988,1,1,1704295068,1704295068,1704295112,44,COMPLETED
5316989,1,1,1704295068,1704295068,1704295110,42,COMPLETED
5316990,1,1,1704295068,1704295068,1704295111,43,COMPLETED
5316991,1,1,1704295068,1704295068,1704295108,40,COMPLETED
5316992,1,1,1704295068,1704295069,1704295111,42,COMPLETED
5316993,1,1,1704295068,1704295069,1704295111,42,COMPLETED
5316994,1,1,1704295068,1704295069,1704295111,42,COMPLETED
5316995,1,1,1704295068,1704295069,1704295111,42,COMPLETED
5316997,1,1,1704295082,1704295083,1704295139,56,COMPLETED
5316998,1,1,1704295082,1704295083,1704295138,55,COMPLETED
5316999,1,1,1704295082,1704295083,1704295142,59,COMPLETED
5317000,1,1,1704295083,1704295083,1704295139,56,COMPLETED
5317001,1,1,1704295083,1704295084,1704295139,55,COMPLETED
5317002,1,1,1704295083,1704295084,1704295140,56,COMPLETED
5317003,1,1,1704295084,1704295084,1704295148,64,COMPLETED
5317004,1,1,1704295084,1704295084,1704295141,57,COMPLETED
5317005,1,1,1704295084,1704295084,1704295138,54,COMPLETED
5317006,1,1,1704295084,1704295084,1704295143,59,COMPLETED
5317007,1,1,1704295084,1704295084,1704295139,55,COMPLETED
5317008,1,1,1704295084,1704295084,1704295139,55,COMPLETED
5317009,1,1,1704295084,1704295084,1704295137,53,COMPLETED
5317010,1,1,1704295084,1704295086,1704295137,51,COMPLETED
5317011,1,1,1704295085,1704295086,1704295140,54,COMPLETED
5317012,1,1,1704295085,1704295086,1704295141,55,COMPLETED
5317013,1,1,1704295085,1704295086,1704295137,51,COMPLETED
5317014,1,1,1704295085,1704295086,1704295137,51,COMPLETED
5317015,1,1,1704295085,1704295086,1704295135,49,COMPLETED
5317016,1,1,1704295085,1704295086,1704295137,51,COMPLETED
5317017,1,1,1704295085,1704295086,1704295139,53,COMPLETED
5317018,1,1,1704295085,1704295086,1704295137,51,COMPLETED
5317019,1,1,1704295085,1704295086,1704295137,51,COMPLETED
5317020,1,1,1704295085,1704295086,1704295143,57,COMPLETED
5317021,1,1,1704295085,1704295086,1704295140,54,COMPLETED
5317022,1,1,1704295086,1704295086,1704295141,55,COMPLETED
5317023,1,1,1704295086,1704295086,1704295132,46,COMPLETED
5317024,1,1,1704295086,1704295087,1704295142,55,COMPLETED
5317025,1,1,1704295086,1704295087,1704295138,51,COMPLETED
5317026,1,1,1704295086,1704295087,1704295140,53,COMPLETED
5317027,1,1,1704295086,1704295087,1704295139,52,COMPLETED
5317028,1,1,1704295086,1704295087,1704295130,43,COMPLETED
5317029,1,1,1704295086,1704295087,1704295127,40,COMPLETED
5317030,1,1,1704295086,1704295087,1704295127,40,COMPLETED
5317031,1,1,1704295086,1704295087,1704295131,44,COMPLETED
5317032,1,1,1704295086,1704295087,1704295130,43,COMPLETED
5317033,1,1,1704295086,1704295087,1704295131,44,COMPLETED
5317034,1,1,1704295086,1704295087,1704295127,40,COMPLETED
5317035,1,1,1704295086,1704295087,1704295127,40,COMPLETED
5317036,1,1,1704295086,1704295087,1704295144,57,COMPLETED
5317037,1,1,1704295087,1704295087,1704295138,51,COMPLETED
5317039,1,1,1704295087,1704295087,1704295142,55,COMPLETED
5317040,1,1,1704295087,1704295087,1704295140,53,COMPLETED
5317041,1,1,1704295087,1704295087,1704295137,50,COMPLETED
5317042,1,1,1704295087,1704295087,1704295143,56,COMPLETED
5317043,1,1,1704295087,1704295087,1704295140,53,COMPLETED
5317044,1,1,1704295087,1704295087,1704295143,56,COMPLETED
5317045,1,1,1704295087,1704295088,1704295141,53,COMPLETED
5317046,1,1,1704295087,1704295088,1704295141,53,COMPLETED
5317038,72,2,1704295087,1704295087,1704295606,519,COMPLETED
5317047,1,1,1704295088,1704295088,1704295139,51,COMPLETED
5317048,1,1,1704295088,1704295088,1704295144,56,COMPLETED
5317049,1,1,1704295088,1704295088,1704295141,53,COMPLETED
5317050,1,1,1704295088,1704295088,1704295137,49,COMPLETED
5317051,1,1,1704295088,1704295088,1704295145,57,COMPLETED
5317052,1,1,1704295088,1704295088,1704295140,52,COMPLETED
5317053,1,1,1704295088,1704295088,1704295141,53,COMPLETED
5317054,1,1,1704295088,1704295089,1704295142,53,COMPLETED
5317055,1,1,1704295088,1704295089,1704295140,51,COMPLETED
5317056,1,1,1704295088,1704295089,1704295143,54,COMPLETED
5317057,1,1,1704295088,1704295089,1704295140,51,COMPLETED
5317058,1,1,1704295088,1704295089,1704295142,53,COMPLETED
5317059,1,1,1704295089,1704295089,1704295142,53,COMPLETED
5317060,1,1,1704295089,1704295089,1704295139,50,COMPLETED
5317061,1,1,1704295089,1704295089,1704295137,48,COMPLETED
5317062,1,1,1704295089,1704295089,1704295141,52,COMPLETED
5317063,1,1,1704295089,1704295089,1704295137,48,COMPLETED
5317064,1,1,1704295089,1704295089,1704295140,51,COMPLETED
5317065,1,1,1704295089,1704295089,1704295143,54,COMPLETED
5317066,1,1,1704295089,1704295089,1704295143,54,COMPLETED
5317067,1,1,1704295089,1704295090,1704295140,50,COMPLETED
5317068,1,1,1704295090,1704295090,1704295138,48,COMPLETED
5317069,1,1,1704295090,1704295090,1704295141,51,COMPLETED
5317070,1,1,1704295090,1704295090,1704295138,48,COMPLETED
5317071,1,1,1704295090,1704295090,1704295143,53,COMPLETED
5317072,1,1,1704295090,1704295092,1704295144,52,COMPLETED
5317073,1,1,1704295090,1704295092,1704295139,47,COMPLETED
5317074,1,1,1704295090,1704295092,1704295142,50,COMPLETED
5317075,1,1,1704295090,1704295092,1704295139,47,COMPLETED
5317076,1,1,1704295090,1704295092,1704295141,49,COMPLETED
5317077,1,1,1704295091,1704295092,1704295142,50,COMPLETED
5317078,1,1,1704295091,1704295092,1704295141,49,COMPLETED
5317079,1,1,1704295091,1704295092,1704295142,50,COMPLETED
5317080,1,1,1704295091,1704295092,1704295142,50,COMPLETED
5317081,1,1,1704295091,1704295092,1704295143,51,COMPLETED
5317082,1,1,1704295091,1704295092,1704295141,49,COMPLETED
5317083,1,1,1704295091,1704295092,1704295141,49,COMPLETED
5317084,1,1,1704295091,1704295092,1704295141,49,COMPLETED
5317085,1,1,1704295091,1704295092,1704295144,52,COMPLETED
5317086,1,1,1704295091,1704295092,1704295142,50,COMPLETED
5317087,1,1,1704295091,1704295092,1704295139,47,COMPLETED
5317088,1,1,1704295091,1704295092,1704295137,45,COMPLETED
5317089,1,1,1704295092,1704295092,1704295140,48,COMPLETED
5317090,1,1,1704295092,1704295092,1704295142,50,COMPLETED
5317091,1,1,1704295092,1704295092,1704295142,50,COMPLETED
5317092,1,1,1704295092,1704295092,1704295143,51,COMPLETED
5317093,1,1,1704295092,1704295092,1704295143,51,COMPLETED
5317094,1,1,1704295092,1704295092,1704295142,50,COMPLETED
5317095,1,1,1704295092,1704295093,1704295143,50,COMPLETED
5317096,1,1,1704295092,1704295093,1704295146,53,COMPLETED
5317097,1,1,1704295092,1704295093,1704295139,46,COMPLETED
5317098,1,1,1704295092,1704295093,1704295139,46,COMPLETED
5317099,1,1,1704295093,1704295093,1704295141,48,COMPLETED
5317100,1,1,1704295093,1704295093,1704295141,48,COMPLETED
5317101,1,1,1704295093,1704295093,1704295141,48,COMPLETED
5317102,1,1,1704295093,1704295093,1704295142,49,COMPLETED
5317103,1,1,1704295093,1704295093,1704295146,53,COMPLETED
5317104,1,1,1704295093,1704295093,1704295139,46,COMPLETED
5317105,1,1,1704295093,1704295093,1704295141,48,COMPLETED
5317106,1,1,1704295093,1704295093,1704295141,48,COMPLETED
5317107,1,1,1704295093,1704295094,1704295141,47,COMPLETED
5317108,1,1,1704295094,1704295094,1704295139,45,COMPLETED
5317109,1,1,1704295094,1704295094,1704295130,36,COMPLETED
5317110,1,1,1704295094,1704295094,1704295137,43,COMPLETED
5317111,1,1,1704295094,1704295094,1704295139,45,COMPLETED
5317112,1,1,1704295094,1704295094,1704295137,43,COMPLETED
5317113,1,1,1704295094,1704295094,1704295133,39,COMPLETED
5317114,1,1,1704295095,1704295095,1704295132,37,COMPLETED
5317115,1,1,1704295095,1704295096,1704295148,52,COMPLETED
5317116,1,1,1704295095,1704295096,1704295138,42,COMPLETED
5317117,1,1,1704295095,1704295096,1704295137,41,COMPLETED
5317118,1,1,1704295096,1704295096,1704295137,41,COMPLETED
5317119,1,1,1704295096,1704295096,1704295137,41,COMPLETED
5317120,1,1,1704295096,1704295096,1704295138,42,COMPLETED
5317121,1,1,1704295097,1704295097,1704295137,40,COMPLETED
5317122,1,1,1704295097,1704295097,1704295137,40,COMPLETED
5317123,1,1,1704295097,1704295097,1704295137,40,COMPLETED
5317124,1,1,1704295097,1704295097,1704295132,35,COMPLETED
5317125,1,1,1704295097,1704295097,1704295137,40,COMPLETED
5317126,1,1,1704295097,1704295097,1704295138,41,COMPLETED
5317127,1,1,1704295097,1704295097,1704295137,40,COMPLETED
5317128,1,1,1704295097,1704295097,1704295138,41,COMPLETED
5317129,1,1,1704295097,1704295097,1704295137,40,COMPLETED
5317130,1,1,1704295097,1704295097,1704295131,34,COMPLETED
5317131,1,1,1704295097,1704295098,1704295137,39,COMPLETED
5317132,1,1,1704295098,1704295098,1704295137,39,COMPLETED
5317133,1,1,1704295098,1704295098,1704295139,41,COMPLETED
5317134,1,1,1704295098,1704295098,1704295138,40,COMPLETED
5317135,1,1,1704295098,1704295098,1704295130,32,COMPLETED
5317137,1,1,1704295098,1704295098,1704295130,32,COMPLETED
5317138,1,1,1704295098,1704295098,1704295130,32,COMPLETED
5317139,1,1,1704295098,1704295098,1704295138,40,COMPLETED
5317140,1,1,1704295098,1704295098,1704295130,32,COMPLETED
5317141,1,1,1704295098,1704295098,1704295130,32,COMPLETED
5317142,1,1,1704295098,1704295100,1704295158,58,COMPLETED
5317143,1,1,1704295098,1704295100,1704295158,58,COMPLETED
5317144,1,1,1704295098,1704295100,1704295158,58,COMPLETED
5317145,1,1,1704295098,1704295100,1704295158,58,COMPLETED
5317146,360,10,1704295109,1704295109,1704467178,172069,FAILED
5317148,1,1,1704295122,1704295123,1704295177,54,COMPLETED
5317149,1,1,1704295123,1704295125,1704295170,45,COMPLETED
5317150,1,1,1704295123,1704295125,1704295173,48,COMPLETED
5317151,1,1,1704295123,1704295125,1704295172,47,COMPLETED
5317152,1,1,1704295123,1704295125,1704295173,48,COMPLETED
5317153,1,1,1704295123,1704295125,1704295179,54,COMPLETED
5317154,1,1,1704295124,1704295125,1704295174,49,COMPLETED
5317155,1,1,1704295124,1704295125,1704295176,51,COMPLETED
5317156,1,1,1704295124,1704295125,1704295173,48,COMPLETED
5317157,1,1,1704295124,1704295125,1704295173,48,COMPLETED
5317158,1,1,1704295124,1704295125,1704295176,51,COMPLETED
5317159,1,1,1704295124,1704295125,1704295173,48,COMPLETED
5317160,1,1,1704295125,1704295125,1704295176,51,COMPLETED
5317161,1,1,1704295125,1704295125,1704295179,54,COMPLETED
5317162,1,1,1704295125,1704295125,1704295170,45,COMPLETED
5317163,1,1,1704295125,1704295125,1704295173,48,COMPLETED
5317164,1,1,1704295125,1704295125,1704295171,46,COMPLETED
5317165,1,1,1704295125,1704295125,1704295179,54,COMPLETED
5317166,1,1,1704295125,1704295125,1704295171,46,COMPLETED
5317167,1,1,1704295125,1704295125,1704295179,54,COMPLETED
5317168,1,1,1704295125,1704295127,1704295177,50,COMPLETED
5317169,1,1,1704295125,1704295127,1704295179,52,COMPLETED
5317170,1,1,1704295125,1704295127,1704295176,49,COMPLETED
5317171,1,1,1704295126,1704295127,1704295187,60,COMPLETED
5317172,1,1,1704295126,1704295127,1704295174,47,COMPLETED
5317173,1,1,1704295126,1704295127,1704295174,47,COMPLETED
5317174,1,1,1704295126,1704295127,1704295172,45,COMPLETED
5317175,1,1,1704295126,1704295127,1704295173,46,COMPLETED
5317176,1,1,1704295126,1704295127,1704295179,52,COMPLETED
5317177,1,1,1704295126,1704295127,1704295176,49,COMPLETED
5317178,1,1,1704295126,1704295127,1704295160,33,COMPLETED
5317179,1,1,1704295126,1704295127,1704295160,33,COMPLETED
5317180,1,1,1704295126,1704295127,1704295160,33,COMPLETED
5317181,1,1,1704295126,1704295127,1704295160,33,COMPLETED
5317182,1,1,1704295126,1704295127,1704295160,33,COMPLETED
5317183,1,1,1704295126,1704295127,1704295160,33,COMPLETED
5317184,1,1,1704295126,1704295127,1704295160,33,COMPLETED
5317185,1,1,1704295127,1704295127,1704295160,33,COMPLETED
5317186,1,1,1704295127,1704295127,1704295161,34,COMPLETED
5317187,1,1,1704295127,1704295127,1704295161,34,COMPLETED
5317188,1,1,1704295127,1704295127,1704295159,32,COMPLETED
5317189,1,1,1704295127,1704295128,1704295161,33,COMPLETED
5317190,1,1,1704295127,1704295128,1704295162,34,COMPLETED
5317191,1,1,1704295127,1704295128,1704295161,33,COMPLETED
5317192,1,1,1704295127,1704295128,1704295161,33,COMPLETED
5317193,1,1,1704295128,1704295128,1704295162,34,COMPLETED
5317194,1,1,1704295128,1704295128,1704295162,34,COMPLETED
5317195,1,1,1704295128,1704295128,1704295158,30,COMPLETED
5317196,1,1,1704295128,1704295128,1704295158,30,COMPLETED
5317197,1,1,1704295128,1704295128,1704295158,30,COMPLETED
5317199,1,1,1704295142,1704295142,1704295187,45,COMPLETED
5317200,1,1,1704295142,1704295142,1704295187,45,COMPLETED
5317201,1,1,1704295142,1704295142,1704295187,45,COMPLETED
5317202,1,1,1704295142,1704295142,1704295187,45,COMPLETED
5317203,1,1,1704295142,1704295142,1704295188,46,COMPLETED
5317204,1,1,1704295142,1704295143,1704295187,44,COMPLETED
5317205,1,1,1704295143,1704295143,1704295197,54,COMPLETED
5317206,1,1,1704295143,1704295143,1704295197,54,COMPLETED
5317207,1,1,1704295143,1704295143,1704295200,57,COMPLETED
5317208,1,1,1704295143,1704295143,1704295198,55,COMPLETED
5317209,1,1,1704295143,1704295143,1704295197,54,COMPLETED
5317210,1,1,1704295143,1704295143,1704295199,56,COMPLETED
5317211,1,1,1704295143,1704295143,1704295198,55,COMPLETED
5317212,1,1,1704295144,1704295144,1704295196,52,COMPLETED
5317213,1,1,1704295144,1704295144,1704295197,53,COMPLETED
5317214,1,1,1704295144,1704295144,1704295201,57,COMPLETED
5317215,1,1,1704295144,1704295144,1704295198,54,COMPLETED
5317216,1,1,1704295144,1704295144,1704295198,54,COMPLETED
5317217,1,1,1704295144,1704295144,1704295198,54,COMPLETED
5317219,1,1,1704295144,1704295144,1704295199,55,COMPLETED
5317220,1,1,1704295144,1704295144,1704295198,54,COMPLETED
5317221,1,1,1704295144,1704295144,1704295198,54,COMPLETED
5317222,1,1,1704295144,1704295144,1704295196,52,COMPLETED
5317223,1,1,1704295144,1704295145,1704295196,51,COMPLETED
5317224,1,1,1704295145,1704295145,1704295199,54,COMPLETED
5317225,1,1,1704295145,1704295145,1704295196,51,COMPLETED
5317226,1,1,1704295145,1704295145,1704295200,55,COMPLETED
5317227,1,1,1704295145,1704295145,1704295200,55,COMPLETED
5317228,1,1,1704295145,1704295145,1704295200,55,COMPLETED
5317229,1,1,1704295145,1704295145,1704295196,51,COMPLETED
5317230,1,1,1704295145,1704295145,1704295201,56,COMPLETED
5317231,1,1,1704295145,1704295145,1704295196,51,COMPLETED
5317232,1,1,1704295145,1704295145,1704295199,54,COMPLETED
5317233,1,1,1704295145,1704295146,1704295199,53,COMPLETED
5317234,1,1,1704295146,1704295146,1704295201,55,COMPLETED
5317235,1,1,1704295146,1704295146,1704295199,53,COMPLETED
5317236,1,1,1704295146,1704295146,1704295196,50,COMPLETED
5317237,1,1,1704295146,1704295146,1704295195,49,COMPLETED
5317238,1,1,1704295146,1704295146,1704295195,49,COMPLETED
5317239,1,1,1704295146,1704295146,1704295196,50,COMPLETED
5317240,1,1,1704295146,1704295146,1704295197,51,COMPLETED
5317241,1,1,1704295146,1704295146,1704295197,51,COMPLETED
5317242,1,1,1704295146,1704295146,1704295198,52,COMPLETED
5317243,1,1,1704295146,1704295147,1704295200,53,COMPLETED
5317244,1,1,1704295147,1704295147,1704295199,52,COMPLETED
5317245,1,1,1704295147,1704295147,1704295198,51,COMPLETED
5317246,1,1,1704295147,1704295147,1704295197,50,COMPLETED
5317247,1,1,1704295147,1704295147,1704295197,50,COMPLETED
5317248,1,1,1704295147,1704295147,1704295200,53,COMPLETED
5317249,1,1,1704295147,1704295147,1704295199,52,COMPLETED
5317250,1,1,1704295147,1704295148,1704295200,52,COMPLETED
5317251,1,1,1704295147,1704295148,1704295203,55,COMPLETED
5317252,1,1,1704295147,1704295148,1704295196,48,COMPLETED
5317253,1,1,1704295148,1704295149,1704295198,49,COMPLETED
5317254,1,1,1704295148,1704295149,1704295199,50,COMPLETED
5317255,1,1,1704295148,1704295149,1704295198,49,COMPLETED
5317256,1,1,1704295148,1704295149,1704295197,48,COMPLETED
5317257,1,1,1704295148,1704295149,1704295197,48,COMPLETED
5317258,1,1,1704295148,1704295149,1704295203,54,COMPLETED
5317259,1,1,1704295148,1704295150,1704295196,46,COMPLETED
5317260,1,1,1704295148,1704295150,1704295196,46,COMPLETED
5317261,1,1,1704295148,1704295150,1704295198,48,COMPLETED
5317262,1,1,1704295148,1704295150,1704295196,46,COMPLETED
5317263,1,1,1704295149,1704295150,1704295197,47,COMPLETED
5317264,1,1,1704295149,1704295150,1704295199,49,COMPLETED
5317265,1,1,1704295149,1704295150,1704295201,51,COMPLETED
5317266,1,1,1704295149,1704295150,1704295199,49,COMPLETED
5317267,1,1,1704295149,1704295150,1704295199,49,COMPLETED
5317268,1,1,1704295149,1704295150,1704295202,52,COMPLETED
5317269,1,1,1704295149,1704295150,1704295198,48,COMPLETED
5317270,1,1,1704295149,1704295150,1704295199,49,COMPLETED
5317271,1,1,1704295149,1704295150,1704295201,51,COMPLETED
5317272,1,1,1704295149,1704295150,1704295202,52,COMPLETED
5317273,1,1,1704295150,1704295150,1704295197,47,COMPLETED
5317274,1,1,1704295150,1704295150,1704295201,51,COMPLETED
5317275,1,1,1704295150,1704295151,1704295201,50,COMPLETED
5317276,1,1,1704295150,1704295151,1704295199,48,COMPLETED
5317277,1,1,1704295150,1704295151,1704295199,48,COMPLETED
5317278,1,1,1704295150,1704295151,1704295200,49,COMPLETED
5317279,1,1,1704295150,1704295151,1704295201,50,COMPLETED
5317280,1,1,1704295150,1704295151,1704295201,50,COMPLETED
5317281,1,1,1704295150,1704295151,1704295201,50,COMPLETED
5317282,1,1,1704295150,1704295151,1704295201,50,COMPLETED
5317283,1,1,1704295151,1704295151,1704295200,49,COMPLETED
5317284,1,1,1704295151,1704295151,1704295201,50,COMPLETED
5317285,1,1,1704295151,1704295151,1704295201,50,COMPLETED
5317286,1,1,1704295151,1704295151,1704295197,46,COMPLETED
5317287,1,1,1704295151,1704295151,1704295201,50,COMPLETED
5317288,1,1,1704295151,1704295151,1704295201,50,COMPLETED
5317289,1,1,1704295151,1704295151,1704295200,49,COMPLETED
5317290,1,1,1704295151,1704295151,1704295198,47,COMPLETED
5317291,1,1,1704295151,1704295151,1704295202,51,COMPLETED
5317292,1,1,1704295151,1704295151,1704295200,49,COMPLETED
5317293,1,1,1704295152,1704295152,1704295200,48,COMPLETED
5317294,1,1,1704295152,1704295152,1704295201,49,COMPLETED
5317295,1,1,1704295152,1704295152,1704295203,51,COMPLETED
5317296,1,1,1704295152,1704295154,1704295200,46,COMPLETED
5317297,1,1,1704295152,1704295154,1704295198,44,COMPLETED
5317298,1,1,1704295152,1704295154,1704295208,54,COMPLETED
5317299,1,1,1704295152,1704295154,1704295197,43,COMPLETED
5317300,1,1,1704295152,1704295154,1704295201,47,COMPLETED
5317301,1,1,1704295153,1704295154,1704295202,48,COMPLETED
5317302,1,1,1704295153,1704295154,1704295199,45,COMPLETED
5317303,1,1,1704295153,1704295154,1704295187,33,COMPLETED
5317304,1,1,1704295153,1704295154,1704295187,33,COMPLETED
5317305,1,1,1704295153,1704295154,1704295187,33,COMPLETED
5317306,1,1,1704295154,1704295154,1704295190,36,COMPLETED
5317307,1,1,1704295154,1704295154,1704295188,34,COMPLETED
5317308,1,1,1704295154,1704295154,1704295188,34,COMPLETED
5317309,1,1,1704295154,1704295154,1704295188,34,COMPLETED
5317310,1,1,1704295154,1704295154,1704295198,44,COMPLETED
5317311,1,1,1704295154,1704295154,1704295188,34,COMPLETED
5317312,1,1,1704295154,1704295154,1704295188,34,COMPLETED
5317313,1,1,1704295154,1704295154,1704295188,34,COMPLETED
5317314,1,1,1704295154,1704295158,1704295197,39,COMPLETED
5317315,1,1,1704295154,1704295158,1704295199,41,COMPLETED
5317316,1,1,1704295154,1704295158,1704295199,41,COMPLETED
5317317,1,1,1704295154,1704295158,1704295196,38,COMPLETED
5317318,1,1,1704295155,1704295158,1704295196,38,COMPLETED
5317319,1,1,1704295155,1704295158,1704295199,41,COMPLETED
5317320,1,1,1704295155,1704295158,1704295196,38,COMPLETED
5317321,1,1,1704295155,1704295158,1704295196,38,COMPLETED
5317322,1,1,1704295155,1704295158,1704295198,40,COMPLETED
5317323,1,1,1704295155,1704295158,1704295199,41,COMPLETED
5317324,1,1,1704295155,1704295158,1704295196,38,COMPLETED
5317325,1,1,1704295155,1704295158,1704295204,46,COMPLETED
5317326,1,1,1704295155,1704295158,1704295199,41,COMPLETED
5317327,1,1,1704295155,1704295158,1704295199,41,COMPLETED
5317328,1,1,1704295155,1704295158,1704295197,39,COMPLETED
5317329,1,1,1704295155,1704295158,1704295198,40,COMPLETED
5317330,1,1,1704295155,1704295158,1704295203,45,COMPLETED
5317331,1,1,1704295155,1704295158,1704295198,40,COMPLETED
5317332,1,1,1704295155,1704295158,1704295197,39,COMPLETED
5317333,1,1,1704295156,1704295158,1704295198,40,COMPLETED
5317334,1,1,1704295156,1704295158,1704295199,41,COMPLETED
5317335,1,1,1704295156,1704295158,1704295199,41,COMPLETED
5317336,1,1,1704295156,1704295158,1704295196,38,COMPLETED
5317337,1,1,1704295156,1704295158,1704295196,38,COMPLETED
5317338,1,1,1704295156,1704295158,1704295196,38,COMPLETED
5317339,1,1,1704295156,1704295158,1704295198,40,COMPLETED
5317340,1,1,1704295156,1704295158,1704295202,44,COMPLETED
5317341,1,1,1704295156,1704295158,1704295199,41,COMPLETED
5317344,1,1,1704295182,1704295183,1704295225,42,COMPLETED
5317345,1,1,1704295182,1704295183,1704295225,42,COMPLETED
5317346,1,1,1704295182,1704295183,1704295225,42,COMPLETED
5317347,1,1,1704295183,1704295183,1704295225,42,COMPLETED
5317348,1,1,1704295183,1704295185,1704295225,40,COMPLETED
5317349,1,1,1704295183,1704295185,1704295225,40,COMPLETED
5317350,1,1,1704295183,1704295185,1704295225,40,COMPLETED
5317351,1,1,1704295183,1704295185,1704295225,40,COMPLETED
5317352,1,1,1704295184,1704295185,1704295225,40,COMPLETED
5317353,1,1,1704295184,1704295185,1704295225,40,COMPLETED
5317354,1,1,1704295184,1704295185,1704295225,40,COMPLETED
5317355,1,1,1704295184,1704295185,1704295225,40,COMPLETED
5317356,1,1,1704295184,1704295185,1704295225,40,COMPLETED
5317357,1,1,1704295184,1704295185,1704295226,41,COMPLETED
5317358,1,1,1704295184,1704295185,1704295225,40,COMPLETED
5317359,1,1,1704295184,1704295185,1704295225,40,COMPLETED
5317360,1,1,1704295185,1704295185,1704295226,41,COMPLETED
5317361,1,1,1704295185,1704295185,1704295225,40,COMPLETED
5317362,1,1,1704295185,1704295187,1704295225,38,COMPLETED
5317363,1,1,1704295185,1704295187,1704295226,39,COMPLETED
5317364,1,1,1704295185,1704295187,1704295225,38,COMPLETED
5317367,1,1,1704295302,1704295302,1704295350,48,COMPLETED
5317368,1,1,1704295302,1704295302,1704295350,48,COMPLETED
5317369,1,1,1704295302,1704295302,1704295350,48,COMPLETED
5317370,1,1,1704295302,1704295302,1704295350,48,COMPLETED
5317371,1,1,1704295302,1704295306,1704295350,44,COMPLETED
5317372,1,1,1704295302,1704295306,1704295350,44,COMPLETED
5317373,1,1,1704295302,1704295306,1704295358,52,COMPLETED
5317374,1,1,1704295302,1704295306,1704295351,45,COMPLETED
5317375,1,1,1704295303,1704295306,1704295351,45,COMPLETED
5317376,1,1,1704295303,1704295306,1704295350,44,COMPLETED
5317377,1,1,1704295303,1704295306,1704295352,46,COMPLETED
5317378,1,1,1704295303,1704295306,1704295351,45,COMPLETED
5317379,1,1,1704295303,1704295306,1704295355,49,COMPLETED
5317380,1,1,1704295303,1704295306,1704295350,44,COMPLETED
5317381,1,1,1704295303,1704295306,1704295351,45,COMPLETED
5317382,1,1,1704295303,1704295306,1704295352,46,COMPLETED
5317383,1,1,1704295303,1704295306,1704295351,45,COMPLETED
5317384,1,1,1704295303,1704295306,1704295350,44,COMPLETED
5317385,1,1,1704295303,1704295306,1704295351,45,COMPLETED
5317386,1,1,1704295304,1704295306,1704295352,46,COMPLETED
5317387,1,1,1704295304,1704295306,1704295351,45,COMPLETED
5317388,1,1,1704295304,1704295306,1704295350,44,COMPLETED
5317389,1,1,1704295304,1704295306,1704295358,52,COMPLETED
5317390,1,1,1704295304,1704295306,1704295350,44,COMPLETED
5317391,1,1,1704295304,1704295306,1704295350,44,COMPLETED
5317392,1,1,1704295304,1704295306,1704295350,44,COMPLETED
5317393,1,1,1704295304,1704295306,1704295352,46,COMPLETED
5317394,1,1,1704295304,1704295306,1704295350,44,COMPLETED
5317395,1,1,1704295304,1704295306,1704295355,49,COMPLETED
5317396,1,1,1704295304,1704295306,1704295351,45,COMPLETED
5317397,1,1,1704295304,1704295306,1704295351,45,COMPLETED
5317398,1,1,1704295304,1704295306,1704295352,46,COMPLETED
5317399,1,1,1704295304,1704295306,1704295352,46,COMPLETED
5317400,1,1,1704295305,1704295306,1704295354,48,COMPLETED
5317401,1,1,1704295305,1704295306,1704295351,45,COMPLETED
5317402,1,1,1704295305,1704295306,1704295352,46,COMPLETED
5317403,1,1,1704295305,1704295306,1704295352,46,COMPLETED
5317404,1,1,1704295305,1704295306,1704295352,46,COMPLETED
5317405,1,1,1704295305,1704295306,1704295352,46,COMPLETED
5317406,1,1,1704295305,1704295306,1704295352,46,COMPLETED
5317407,1,1,1704295305,1704295306,1704295352,46,COMPLETED
5317408,1,1,1704295305,1704295306,1704295354,48,COMPLETED
5317409,1,1,1704295305,1704295306,1704295354,48,COMPLETED
5317410,1,1,1704295305,1704295306,1704295352,46,COMPLETED
5317411,1,1,1704295305,1704295306,1704295352,46,COMPLETED
5317412,1,1,1704295305,1704295306,1704295352,46,COMPLETED
5317413,1,1,1704295305,1704295306,1704295352,46,COMPLETED
5317414,1,1,1704295305,1704295306,1704295352,46,COMPLETED
5317415,1,1,1704295305,1704295306,1704295352,46,COMPLETED
5317416,1,1,1704295305,1704295306,1704295352,46,COMPLETED
5317417,1,1,1704295305,1704295306,1704295352,46,COMPLETED
5317418,1,1,1704295305,1704295306,1704295352,46,COMPLETED
5317419,1,1,1704295305,1704295306,1704295352,46,COMPLETED
5317420,1,1,1704295305,1704295306,1704295352,46,COMPLETED
5317421,1,1,1704295306,1704295306,1704295352,46,COMPLETED
5317422,1,1,1704295306,1704295306,1704295352,46,COMPLETED
5317423,1,1,1704295306,1704295306,1704295353,47,COMPLETED
5317424,1,1,1704295306,1704295306,1704295352,46,COMPLETED
5317425,1,1,1704295306,1704295306,1704295352,46,COMPLETED
5317426,1,1,1704295306,1704295306,1704295352,46,COMPLETED
5317427,1,1,1704295306,1704295306,1704295352,46,COMPLETED
5317428,1,1,1704295306,1704295306,1704295352,46,COMPLETED
5317429,1,1,1704295306,1704295306,1704295352,46,COMPLETED
5317430,1,1,1704295306,1704295306,1704295352,46,COMPLETED
5317431,1,1,1704295306,1704295306,1704295353,47,COMPLETED
5317432,1,1,1704295306,1704295306,1704295350,44,COMPLETED
5317433,1,1,1704295306,1704295306,1704295350,44,COMPLETED
5317434,1,1,1704295306,1704295306,1704295352,46,COMPLETED
5317435,1,1,1704295306,1704295306,1704295354,48,COMPLETED
5317436,1,1,1704295306,1704295306,1704295352,46,COMPLETED
5317437,1,1,1704295306,1704295306,1704295352,46,COMPLETED
5317438,1,1,1704295306,1704295306,1704295352,46,COMPLETED
5317439,1,1,1704295306,1704295306,1704295352,46,COMPLETED
5317440,1,1,1704295306,1704295306,1704295352,46,COMPLETED
5317441,1,1,1704295306,1704295306,1704295352,46,COMPLETED
5317442,1,1,1704295306,1704295306,1704295350,44,COMPLETED
5317443,1,1,1704295306,1704295306,1704295350,44,COMPLETED
5317444,1,1,1704295306,1704295306,1704295350,44,COMPLETED
5317445,1,1,1704295306,1704295306,1704295350,44,COMPLETED
5317446,1,1,1704295306,1704295306,1704295352,46,COMPLETED
5317447,1,1,1704295306,1704295306,1704295350,44,COMPLETED
5317448,1,1,1704295306,1704295306,1704295350,44,COMPLETED
5317449,1,1,1704295306,1704295306,1704295352,46,COMPLETED
5317450,1,1,1704295306,1704295306,1704295352,46,COMPLETED
5317451,1,1,1704295306,1704295306,1704295354,48,COMPLETED
5317452,1,1,1704295306,1704295306,1704295350,44,COMPLETED
5317453,1,1,1704295306,1704295306,1704295352,46,COMPLETED
5317454,1,1,1704295306,1704295306,1704295352,46,COMPLETED
5317455,1,1,1704295306,1704295306,1704295352,46,COMPLETED
5317456,1,1,1704295306,1704295306,1704295352,46,COMPLETED
5317457,1,1,1704295306,1704295310,1704295352,42,COMPLETED
5317458,1,1,1704295307,1704295310,1704295356,46,COMPLETED
5317459,1,1,1704295307,1704295310,1704295359,49,COMPLETED
5317460,1,1,1704295307,1704295310,1704295353,43,COMPLETED
5317461,1,1,1704295307,1704295310,1704295352,42,COMPLETED
5317462,1,1,1704295307,1704295310,1704295354,44,COMPLETED
5317463,1,1,1704295307,1704295310,1704295354,44,COMPLETED
5317464,1,1,1704295307,1704295310,1704295352,42,COMPLETED
5317465,1,1,1704295307,1704295310,1704295353,43,COMPLETED
5317466,1,1,1704295307,1704295310,1704295353,43,COMPLETED
5317467,1,1,1704295307,1704295310,1704295354,44,COMPLETED
5317468,1,1,1704295307,1704295310,1704295353,43,COMPLETED
5317469,1,1,1704295307,1704295310,1704295352,42,COMPLETED
5317470,1,1,1704295307,1704295310,1704295353,43,COMPLETED
5317471,1,1,1704295307,1704295310,1704295358,48,COMPLETED
5317472,1,1,1704295307,1704295310,1704295352,42,COMPLETED
5317473,1,1,1704295307,1704295310,1704295352,42,COMPLETED
5317474,1,1,1704295307,1704295310,1704295355,45,COMPLETED
5317475,1,1,1704295307,1704295310,1704295360,50,COMPLETED
5317476,1,1,1704295307,1704295310,1704295352,42,COMPLETED
5317477,1,1,1704295307,1704295310,1704295357,47,COMPLETED
5317478,1,1,1704295307,1704295310,1704295353,43,COMPLETED
5317479,1,1,1704295307,1704295310,1704295357,47,COMPLETED
5317480,1,1,1704295308,1704295310,1704295355,45,COMPLETED
5317481,1,1,1704295308,1704295310,1704295351,41,COMPLETED
5317482,1,1,1704295308,1704295310,1704295351,41,COMPLETED
5317483,1,1,1704295308,1704295310,1704295350,40,COMPLETED
5317484,1,1,1704295308,1704295310,1704295351,41,COMPLETED
5317485,1,1,1704295308,1704295310,1704295354,44,COMPLETED
5317486,1,1,1704295308,1704295310,1704295361,51,COMPLETED
5317487,1,1,1704295308,1704295310,1704295351,41,COMPLETED
5317488,1,1,1704295308,1704295310,1704295352,42,COMPLETED
5317489,1,1,1704295308,1704295310,1704295350,40,COMPLETED
5317490,1,1,1704295308,1704295310,1704295359,49,COMPLETED
5317491,1,1,1704295308,1704295310,1704295354,44,COMPLETED
5317492,1,1,1704295308,1704295310,1704295354,44,COMPLETED
5317493,1,1,1704295308,1704295310,1704295355,45,COMPLETED
5317494,1,1,1704295308,1704295310,1704295352,42,COMPLETED
5317495,1,1,1704295308,1704295310,1704295352,42,COMPLETED
5317496,1,1,1704295308,1704295310,1704295356,46,COMPLETED
5317497,1,1,1704295308,1704295310,1704295357,47,COMPLETED
5317498,1,1,1704295308,1704295310,1704295352,42,COMPLETED
5317499,1,1,1704295308,1704295310,1704295351,41,COMPLETED
5317500,1,1,1704295308,1704295310,1704295353,43,COMPLETED
5317501,1,1,1704295308,1704295310,1704295354,44,COMPLETED
5317502,1,1,1704295308,1704295310,1704295350,40,COMPLETED
5317503,1,1,1704295308,1704295310,1704295351,41,COMPLETED
5317504,1,1,1704295308,1704295310,1704295360,50,COMPLETED
5317505,1,1,1704295308,1704295310,1704295353,43,COMPLETED
5317506,1,1,1704295308,1704295310,1704295356,46,COMPLETED
5317507,1,1,1704295308,1704295310,1704295358,48,COMPLETED
5317508,1,1,1704295308,1704295310,1704295351,41,COMPLETED
5317509,1,1,1704295308,1704295310,1704295350,40,COMPLETED
5317510,1,1,1704295308,1704295310,1704295353,43,COMPLETED
5317511,1,1,1704295308,1704295310,1704295352,42,COMPLETED
5317512,1,1,1704295308,1704295310,1704295355,45,COMPLETED
5317513,1,1,1704295308,1704295310,1704295353,43,COMPLETED
5317514,1,1,1704295308,1704295310,1704295352,42,COMPLETED
5317515,1,1,1704295308,1704295310,1704295356,46,COMPLETED
5317516,1,1,1704295308,1704295310,1704295355,45,COMPLETED
5317517,1,1,1704295308,1704295310,1704295354,44,COMPLETED
5317518,1,1,1704295308,1704295310,1704295355,45,COMPLETED
5317519,1,1,1704295308,1704295310,1704295355,45,COMPLETED
5317520,1,1,1704295309,1704295310,1704295352,42,COMPLETED
5317521,1,1,1704295309,1704295310,1704295357,47,COMPLETED
5317522,1,1,1704295309,1704295310,1704295352,42,COMPLETED
5317523,1,1,1704295309,1704295310,1704295355,45,COMPLETED
5317524,1,1,1704295309,1704295310,1704295354,44,COMPLETED
5317525,1,1,1704295309,1704295310,1704295352,42,COMPLETED
5317526,1,1,1704295309,1704295310,1704295353,43,COMPLETED
5317527,1,1,1704295309,1704295310,1704295352,42,COMPLETED
5317528,1,1,1704295309,1704295310,1704295354,44,COMPLETED
5317529,1,1,1704295309,1704295310,1704295357,47,COMPLETED
5317530,1,1,1704295309,1704295310,1704295354,44,COMPLETED
5317531,1,1,1704295309,1704295310,1704295352,42,COMPLETED
5317532,1,1,1704295309,1704295310,1704295352,42,COMPLETED
5317533,1,1,1704295309,1704295310,1704295355,45,COMPLETED
5317534,1,1,1704295309,1704295310,1704295355,45,COMPLETED
5317535,1,1,1704295309,1704295310,1704295352,42,COMPLETED
5317536,1,1,1704295309,1704295310,1704295354,44,COMPLETED
5317537,1,1,1704295309,1704295310,1704295354,44,COMPLETED
5317538,1,1,1704295309,1704295310,1704295360,50,COMPLETED
5317539,1,1,1704295309,1704295310,1704295354,44,COMPLETED
5317540,1,1,1704295309,1704295310,1704295354,44,COMPLETED
5317541,1,1,1704295309,1704295310,1704295354,44,COMPLETED
5317542,1,1,1704295309,1704295310,1704295356,46,COMPLETED
5317543,1,1,1704295309,1704295310,1704295356,46,COMPLETED
5317544,1,1,1704295309,1704295310,1704295356,46,COMPLETED
5317545,1,1,1704295309,1704295310,1704295352,42,COMPLETED
5317546,1,1,1704295309,1704295310,1704295353,43,COMPLETED
5317547,1,1,1704295309,1704295310,1704295350,40,COMPLETED
5317548,1,1,1704295309,1704295310,1704295350,40,COMPLETED
5317549,1,1,1704295309,1704295310,1704295350,40,COMPLETED
5317550,1,1,1704295309,1704295310,1704295356,46,COMPLETED
5317551,1,1,1704295309,1704295310,1704295350,40,COMPLETED
5317552,1,1,1704295309,1704295310,1704295355,45,COMPLETED
5317553,1,1,1704295310,1704295310,1704295350,40,COMPLETED
5317554,1,1,1704295310,1704295310,1704295352,42,COMPLETED
5317555,1,1,1704295310,1704295310,1704295350,40,COMPLETED
5317556,1,1,1704295310,1704295310,1704295350,40,COMPLETED
5317557,1,1,1704295310,1704295310,1704295350,40,COMPLETED
5317558,1,1,1704295310,1704295310,1704295350,40,COMPLETED
5317559,1,1,1704295310,1704295310,1704295352,42,COMPLETED
5317560,1,1,1704295310,1704295310,1704295352,42,COMPLETED
5317561,1,1,1704295310,1704295310,1704295352,42,COMPLETED
5317562,1,1,1704295310,1704295310,1704295353,43,COMPLETED
5317563,1,1,1704295310,1704295310,1704295350,40,COMPLETED
5317564,1,1,1704295310,1704295310,1704295350,40,COMPLETED
5317565,1,1,1704295310,1704295310,1704295350,40,COMPLETED
5317566,1,1,1704295310,1704295310,1704295352,42,COMPLETED
5317567,1,1,1704295350,1704295351,1704295379,28,COMPLETED
5317568,1,1,1704295352,1704295353,1704295379,26,COMPLETED
5317569,1,1,1704295352,1704295353,1704295379,26,COMPLETED
5317570,1,1,1704295352,1704295353,1704295379,26,COMPLETED
5317571,1,1,1704295353,1704295353,1704295379,26,COMPLETED
5317572,1,1,1704295353,1704295353,1704295379,26,COMPLETED
5317573,1,1,1704295354,1704295354,1704295379,25,COMPLETED
5317574,1,1,1704295354,1704295354,1704295380,26,COMPLETED
5317575,1,1,1704295354,1704295354,1704295379,25,COMPLETED
5317576,1,1,1704295354,1704295355,1704295379,24,COMPLETED
5317577,1,1,1704295354,1704295355,1704295379,24,COMPLETED
5317578,1,1,1704295355,1704295355,1704295379,24,COMPLETED
5317579,1,1,1704295355,1704295355,1704295379,24,COMPLETED
5317580,1,1,1704295355,1704295355,1704295379,24,COMPLETED
5317581,1,1,1704295355,1704295355,1704295379,24,COMPLETED
5317582,1,1,1704295355,1704295355,1704295379,24,COMPLETED
5317583,1,1,1704295355,1704295355,1704295379,24,COMPLETED
5317584,1,1,1704295355,1704295356,1704295379,23,COMPLETED
5317585,1,1,1704295356,1704295356,1704295378,22,COMPLETED
5317586,1,1,1704295356,1704295356,1704295379,23,COMPLETED
5317587,1,1,1704295356,1704295356,1704295378,22,COMPLETED
5317588,1,1,1704295356,1704295356,1704295378,22,COMPLETED
5317589,1,1,1704295356,1704295356,1704295378,22,COMPLETED
5317590,1,1,1704295356,1704295356,1704295378,22,COMPLETED
5317591,1,1,1704295367,1704295367,1704295388,21,COMPLETED
5317592,1,1,1704295367,1704295367,1704295390,23,COMPLETED
5317593,1,1,1704295367,1704295367,1704295391,24,COMPLETED
5317594,1,1,1704295368,1704295371,1704295401,30,COMPLETED
5317595,1,1,1704295368,1704295371,1704295401,30,COMPLETED
5317597,1,1,1704295368,1704295371,1704295401,30,COMPLETED
5317598,1,1,1704295368,1704295371,1704295401,30,COMPLETED
5317599,1,1,1704295368,1704295371,1704295401,30,COMPLETED
5317600,1,1,1704295368,1704295371,1704295401,30,COMPLETED
5317601,1,1,1704295368,1704295371,1704295401,30,COMPLETED
5317602,1,1,1704295368,1704295371,1704295401,30,COMPLETED
5317603,1,1,1704295368,1704295371,1704295401,30,COMPLETED
5317596,1,1,1704295368,1704295371,1704295561,190,COMPLETED
5317604,1,1,1704295369,1704295371,1704295401,30,COMPLETED
5317605,1,1,1704295369,1704295371,1704295414,43,COMPLETED
5317606,1,1,1704295369,1704295371,1704295401,30,COMPLETED
5317607,1,1,1704295369,1704295371,1704295401,30,COMPLETED
5317608,1,1,1704295369,1704295371,1704295401,30,COMPLETED
5317609,1,1,1704295369,1704295371,1704295401,30,COMPLETED
5317610,1,1,1704295369,1704295371,1704295401,30,COMPLETED
5317611,1,1,1704295369,1704295371,1704295401,30,COMPLETED
5317612,1,1,1704295369,1704295371,1704295401,30,COMPLETED
5317613,1,1,1704295369,1704295371,1704295401,30,COMPLETED
5317614,1,1,1704295370,1704295371,1704295401,30,COMPLETED
5317615,1,1,1704295370,1704295371,1704295401,30,COMPLETED
5317616,1,1,1704295370,1704295371,1704295401,30,COMPLETED
5317617,1,1,1704295370,1704295371,1704295401,30,COMPLETED
5317618,1,1,1704295370,1704295371,1704295397,26,COMPLETED
5317619,1,1,1704295370,1704295371,1704295401,30,COMPLETED
5317620,1,1,1704295370,1704295371,1704295397,26,COMPLETED
5317621,1,1,1704295370,1704295371,1704295391,20,COMPLETED
5317622,1,1,1704295370,1704295371,1704295390,19,COMPLETED
5317623,1,1,1704295370,1704295371,1704295390,19,COMPLETED
5317624,1,1,1704295371,1704295371,1704295390,19,COMPLETED
5317625,1,1,1704295371,1704295371,1704295394,23,COMPLETED
5317626,1,1,1704295371,1704295371,1704295390,19,COMPLETED
5317627,1,1,1704295371,1704295371,1704295390,19,COMPLETED
5317628,1,1,1704295371,1704295371,1704295390,19,COMPLETED
5317629,1,1,1704295371,1704295371,1704295390,19,COMPLETED
5317630,1,1,1704295371,1704295371,1704295390,19,COMPLETED
5317631,1,1,1704295371,1704295372,1704295421,49,COMPLETED
5317632,1,1,1704295371,1704295372,1704295421,49,COMPLETED
5317633,1,1,1704295371,1704295373,1704295421,48,COMPLETED
5317634,1,1,1704295372,1704295373,1704295422,49,COMPLETED
5317635,1,1,1704295372,1704295373,1704295422,49,COMPLETED
5317636,1,1,1704295372,1704295373,1704295421,48,COMPLETED
5317637,1,1,1704295372,1704295373,1704295423,50,COMPLETED
5317638,1,1,1704295372,1704295373,1704295421,48,COMPLETED
5317639,1,1,1704295372,1704295373,1704295421,48,COMPLETED
5317640,1,1,1704295372,1704295373,1704295422,49,COMPLETED
5317641,1,1,1704295372,1704295373,1704295421,48,COMPLETED
5317642,1,1,1704295372,1704295373,1704295421,48,COMPLETED
5317643,1,1,1704295372,1704295373,1704295421,48,COMPLETED
5317644,1,1,1704295373,1704295375,1704295421,46,COMPLETED
5317645,1,1,1704295373,1704295375,1704295425,50,COMPLETED
5317646,1,1,1704295373,1704295375,1704295423,48,COMPLETED
5317647,1,1,1704295373,1704295375,1704295423,48,COMPLETED
5317648,1,1,1704295373,1704295375,1704295415,40,COMPLETED
5317649,1,1,1704295373,1704295375,1704295421,46,COMPLETED
5317650,1,1,1704295373,1704295375,1704295422,47,COMPLETED
5317651,1,1,1704295373,1704295375,1704295425,50,COMPLETED
5317652,1,1,1704295373,1704295375,1704295424,49,COMPLETED
5317653,1,1,1704295373,1704295375,1704295424,49,COMPLETED
5317654,1,1,1704295374,1704295375,1704295425,50,COMPLETED
5317655,1,1,1704295374,1704295375,1704295425,50,COMPLETED
5317656,1,1,1704295374,1704295375,1704295424,49,COMPLETED
5317657,1,1,1704295374,1704295375,1704295425,50,COMPLETED
5317658,1,1,1704295374,1704295375,1704295423,48,COMPLETED
5317659,1,1,1704295374,1704295375,1704295422,47,COMPLETED
5317660,1,1,1704295374,1704295375,1704295425,50,COMPLETED
5317661,1,1,1704295374,1704295375,1704295424,49,COMPLETED
5317662,1,1,1704295374,1704295375,1704295422,47,COMPLETED
5317663,1,1,1704295374,1704295375,1704295426,51,COMPLETED
5317664,1,1,1704295375,1704295375,1704295427,52,COMPLETED
5317665,1,1,1704295375,1704295375,1704295422,47,COMPLETED
5317666,1,1,1704295375,1704295375,1704295425,50,COMPLETED
5317667,1,1,1704295375,1704295375,1704295425,50,COMPLETED
5317668,1,1,1704295375,1704295375,1704295422,47,COMPLETED
5317669,1,1,1704295375,1704295375,1704295428,53,COMPLETED
5317670,1,1,1704295375,1704295379,1704295426,47,COMPLETED
5317671,1,1,1704295375,1704295379,1704295436,57,COMPLETED
5317672,1,1,1704295375,1704295379,1704295423,44,COMPLETED
5317673,1,1,1704295375,1704295379,1704295424,45,COMPLETED
5317674,1,1,1704295376,1704295379,1704295423,44,COMPLETED
5317675,1,1,1704295376,1704295379,1704295423,44,COMPLETED
5317676,1,1,1704295376,1704295379,1704295422,43,COMPLETED
5317677,1,1,1704295376,1704295379,1704295424,45,COMPLETED
5317678,1,1,1704295376,1704295379,1704295422,43,COMPLETED
5317679,1,1,1704295376,1704295379,1704295434,55,COMPLETED
5317680,1,1,1704295376,1704295379,1704295424,45,COMPLETED
5317681,1,1,1704295376,1704295379,1704295422,43,COMPLETED
5317682,1,1,1704295376,1704295379,1704295423,44,COMPLETED
5317683,1,1,1704295376,1704295379,1704295426,47,COMPLETED
5317684,1,1,1704295377,1704295379,1704295424,45,COMPLETED
5317685,1,1,1704295377,1704295379,1704295421,42,COMPLETED
5317686,1,1,1704295377,1704295379,1704295421,42,COMPLETED
5317687,1,1,1704295377,1704295379,1704295424,45,COMPLETED
5317688,1,1,1704295377,1704295379,1704295425,46,COMPLETED
5317689,1,1,1704295377,1704295379,1704295423,44,COMPLETED
5317690,1,1,1704295377,1704295379,1704295421,42,COMPLETED
5317691,1,1,1704295377,1704295379,1704295421,42,COMPLETED
5317692,1,1,1704295377,1704295379,1704295424,45,COMPLETED
5317693,1,1,1704295377,1704295379,1704295423,44,COMPLETED
5317694,1,1,1704295378,1704295379,1704295426,47,COMPLETED
5317695,1,1,1704295378,1704295379,1704295424,45,COMPLETED
5317696,1,1,1704295378,1704295379,1704295428,49,COMPLETED
5317697,1,1,1704295378,1704295379,1704295426,47,COMPLETED
5317698,1,1,1704295378,1704295379,1704295425,46,COMPLETED
5317699,1,1,1704295378,1704295379,1704295421,42,COMPLETED
5317700,1,1,1704295378,1704295379,1704295431,52,COMPLETED
5317701,1,1,1704295378,1704295379,1704295423,44,COMPLETED
5317702,1,1,1704295378,1704295379,1704295425,46,COMPLETED
5317703,1,1,1704295378,1704295379,1704295424,45,COMPLETED
5317704,1,1,1704295379,1704295379,1704295422,43,COMPLETED
5317705,1,1,1704295379,1704295379,1704295423,44,COMPLETED
5317706,1,1,1704295379,1704295379,1704295423,44,COMPLETED
5317707,1,1,1704295379,1704295379,1704295423,44,COMPLETED
5317708,1,1,1704295379,1704295379,1704295426,47,COMPLETED
5317709,1,1,1704295379,1704295379,1704295419,40,COMPLETED
5317710,1,1,1704295379,1704295379,1704295433,54,COMPLETED
5317711,1,1,1704295379,1704295379,1704295422,43,COMPLETED
5317712,1,1,1704295380,1704295380,1704295418,38,COMPLETED
5317713,1,1,1704295380,1704295380,1704295428,48,COMPLETED
5317714,1,1,1704295380,1704295380,1704295414,34,COMPLETED
5317715,1,1,1704295380,1704295380,1704295416,36,COMPLETED
5317716,1,1,1704295380,1704295380,1704295414,34,COMPLETED
5317717,1,1,1704295380,1704295380,1704295415,35,COMPLETED
5317718,1,1,1704295380,1704295380,1704295414,34,COMPLETED
5317719,1,1,1704295380,1704295381,1704295421,40,COMPLETED
5317720,1,1,1704295380,1704295381,1704295423,42,COMPLETED
5317721,1,1,1704295380,1704295381,1704295421,40,COMPLETED
5317722,1,1,1704295380,1704295381,1704295421,40,COMPLETED
5317723,1,1,1704295380,1704295381,1704295421,40,COMPLETED
5317724,1,1,1704295381,1704295381,1704295421,40,COMPLETED
5317725,1,1,1704295381,1704295383,1704295421,38,COMPLETED
5317726,1,1,1704295381,1704295383,1704295422,39,COMPLETED
5317727,1,1,1704295381,1704295383,1704295425,42,COMPLETED
5317728,1,1,1704295381,1704295383,1704295426,43,COMPLETED
5317729,1,1,1704295381,1704295383,1704295414,31,COMPLETED
5317730,1,1,1704295381,1704295383,1704295426,43,COMPLETED
5317731,1,1,1704295381,1704295383,1704295421,38,COMPLETED
5317732,1,1,1704295381,1704295383,1704295424,41,COMPLETED
5317733,1,1,1704295381,1704295383,1704295422,39,COMPLETED
5317734,1,1,1704295382,1704295383,1704295421,38,COMPLETED
5317735,1,1,1704295382,1704295383,1704295421,38,COMPLETED
5317736,1,1,1704295382,1704295383,1704295417,34,COMPLETED
5317737,1,1,1704295382,1704295383,1704295421,38,COMPLETED
5317738,1,1,1704295382,1704295383,1704295417,34,COMPLETED
5317739,1,1,1704295382,1704295383,1704295414,31,COMPLETED
5317740,1,1,1704295382,1704295383,1704295421,38,COMPLETED
5317741,1,1,1704295382,1704295383,1704295427,44,COMPLETED
5317742,1,1,1704295382,1704295383,1704295425,42,COMPLETED
5317743,1,1,1704295382,1704295383,1704295422,39,COMPLETED
5317744,1,1,1704295383,1704295383,1704295417,34,COMPLETED
5317745,1,1,1704295383,1704295383,1704295417,34,COMPLETED
5317746,1,1,1704295383,1704295383,1704295421,38,COMPLETED
5317747,1,1,1704295383,1704295383,1704295424,41,COMPLETED
5317748,1,1,1704295383,1704295383,1704295421,38,COMPLETED
5317749,1,1,1704295383,1704295383,1704295416,33,COMPLETED
5317750,1,1,1704295383,1704295383,1704295417,34,COMPLETED
5317751,1,1,1704295383,1704295383,1704295414,31,COMPLETED
5317752,1,1,1704295383,1704295383,1704295417,34,COMPLETED
5317753,1,1,1704295383,1704295383,1704295421,38,COMPLETED
5317754,1,1,1704295384,1704295387,1704295446,59,COMPLETED
5317755,1,1,1704295384,1704295387,1704295445,58,COMPLETED
5317756,1,1,1704295384,1704295387,1704295445,58,COMPLETED
5317757,1,1,1704295384,1704295387,1704295447,60,COMPLETED
5317758,1,1,1704295384,1704295387,1704295445,58,COMPLETED
5317759,1,1,1704295384,1704295387,1704295446,59,COMPLETED
5317760,1,1,1704295384,1704295387,1704295446,59,COMPLETED
5317761,1,1,1704295384,1704295387,1704295446,59,COMPLETED
5317762,1,1,1704295384,1704295387,1704295446,59,COMPLETED
5317763,1,1,1704295384,1704295387,1704295446,59,COMPLETED
5317764,1,1,1704295385,1704295387,1704295446,59,COMPLETED
5317765,1,1,1704295385,1704295387,1704295446,59,COMPLETED
5317766,1,1,1704295385,1704295387,1704295446,59,COMPLETED
5317767,1,1,1704295385,1704295387,1704295446,59,COMPLETED
5317768,1,1,1704295385,1704295387,1704295446,59,COMPLETED
5317769,1,1,1704295385,1704295387,1704295445,58,COMPLETED
5317770,1,1,1704295385,1704295387,1704295446,59,COMPLETED
5317771,1,1,1704295385,1704295387,1704295442,55,COMPLETED
5317772,1,1,1704295385,1704295387,1704295442,55,COMPLETED
5317773,1,1,1704295386,1704295387,1704295442,55,COMPLETED
5317774,1,1,1704295395,1704295395,1704295442,47,COMPLETED
5317775,1,1,1704295395,1704295395,1704295443,48,COMPLETED
5317776,1,1,1704295395,1704295395,1704295443,48,COMPLETED
5317777,1,1,1704295397,1704295398,1704295442,44,COMPLETED
5317778,1,1,1704295397,1704295398,1704295442,44,COMPLETED
5317779,1,1,1704295398,1704295399,1704295442,43,COMPLETED
5317780,1,1,1704295398,1704295399,1704295442,43,COMPLETED
5317781,1,1,1704295398,1704295399,1704295443,44,COMPLETED
5317782,1,1,1704295398,1704295399,1704295442,43,COMPLETED
5317783,1,1,1704295398,1704295399,1704295442,43,COMPLETED
5317784,1,1,1704295398,1704295399,1704295442,43,COMPLETED
5317785,1,1,1704295398,1704295399,1704295446,47,COMPLETED
5317786,1,1,1704295398,1704295399,1704295443,44,COMPLETED
5317787,1,1,1704295398,1704295399,1704295447,48,COMPLETED
5317788,1,1,1704295399,1704295399,1704295442,43,COMPLETED
5317789,1,1,1704295412,1704295412,1704295449,37,COMPLETED
5317790,1,1,1704295412,1704295412,1704295447,35,COMPLETED
5317791,1,1,1704295412,1704295412,1704295447,35,COMPLETED
5317792,1,1,1704295412,1704295415,1704295450,35,COMPLETED
5317793,1,1,1704295412,1704295415,1704295449,34,COMPLETED
5317794,1,1,1704295413,1704295415,1704295467,52,COMPLETED
5317795,1,1,1704295413,1704295415,1704295451,36,COMPLETED
5317796,1,1,1704295413,1704295415,1704295450,35,COMPLETED
5317797,1,1,1704295413,1704295415,1704295448,33,COMPLETED
5317798,1,1,1704295413,1704295415,1704295449,34,COMPLETED
5317799,1,1,1704295413,1704295415,1704295450,35,COMPLETED
5317800,1,1,1704295413,1704295415,1704295449,34,COMPLETED
5317801,1,1,1704295414,1704295415,1704295448,33,COMPLETED
5317802,1,1,1704295414,1704295415,1704295449,34,COMPLETED
5317803,1,1,1704295414,1704295415,1704295448,33,COMPLETED
5317804,1,1,1704295414,1704295415,1704295450,35,COMPLETED
5317805,1,1,1704295414,1704295415,1704295448,33,COMPLETED
5317806,1,1,1704295427,1704295427,1704295483,56,COMPLETED
5317807,1,1,1704295427,1704295427,1704295481,54,COMPLETED
5317808,1,1,1704295427,1704295427,1704295478,51,COMPLETED
5317809,1,1,1704295427,1704295427,1704295488,61,COMPLETED
5317810,1,1,1704295427,1704295427,1704295481,54,COMPLETED
5317811,1,1,1704295427,1704295428,1704295489,61,COMPLETED
5317812,1,1,1704295427,1704295428,1704295480,52,COMPLETED
5317813,1,1,1704295427,1704295428,1704295480,52,COMPLETED
5317814,1,1,1704295427,1704295428,1704295481,53,COMPLETED
5317815,1,1,1704295428,1704295428,1704295480,52,COMPLETED
5317816,1,1,1704295428,1704295428,1704295480,52,COMPLETED
5317817,1,1,1704295428,1704295428,1704295483,55,COMPLETED
5317818,1,1,1704295428,1704295428,1704295481,53,COMPLETED
5317819,1,1,1704295428,1704295428,1704295482,54,COMPLETED
5317820,1,1,1704295428,1704295428,1704295480,52,COMPLETED
5317821,1,1,1704295428,1704295428,1704295490,62,COMPLETED
5317822,1,1,1704295428,1704295428,1704295482,54,COMPLETED
5317823,1,1,1704295428,1704295428,1704295482,54,COMPLETED
5317824,1,1,1704295428,1704295429,1704295478,49,COMPLETED
5317825,1,1,1704295429,1704295429,1704295478,49,COMPLETED
5317826,1,1,1704295429,1704295431,1704295488,57,COMPLETED
5317827,1,1,1704295429,1704295431,1704295481,50,COMPLETED
5317828,1,1,1704295429,1704295431,1704295478,47,COMPLETED
5317829,1,1,1704295429,1704295431,1704295481,50,COMPLETED
5317830,1,1,1704295429,1704295431,1704295478,47,COMPLETED
5317831,1,1,1704295429,1704295431,1704295480,49,COMPLETED
5317832,1,1,1704295429,1704295431,1704295482,51,COMPLETED
5317833,1,1,1704295429,1704295431,1704295483,52,COMPLETED
5317834,1,1,1704295429,1704295431,1704295474,43,COMPLETED
5317835,1,1,1704295430,1704295431,1704295475,44,COMPLETED
5317836,1,1,1704295430,1704295431,1704295478,47,COMPLETED
5317837,1,1,1704295430,1704295431,1704295476,45,COMPLETED
5317838,1,1,1704295430,1704295431,1704295478,47,COMPLETED
5317839,1,1,1704295430,1704295431,1704295475,44,COMPLETED
5317840,1,1,1704295430,1704295431,1704295477,46,COMPLETED
5317841,1,1,1704295430,1704295431,1704295477,46,COMPLETED
5317842,1,1,1704295430,1704295431,1704295477,46,COMPLETED
5317843,1,1,1704295430,1704295431,1704295477,46,COMPLETED
5317844,1,1,1704295430,1704295431,1704295476,45,COMPLETED
5317845,1,1,1704295431,1704295431,1704295477,46,COMPLETED
5317846,1,1,1704295431,1704295431,1704295478,47,COMPLETED
5317847,1,1,1704295431,1704295431,1704295476,45,COMPLETED
5317848,1,1,1704295431,1704295431,1704295485,54,COMPLETED
5317849,1,1,1704295431,1704295431,1704295477,46,COMPLETED
5317850,1,1,1704295431,1704295431,1704295479,48,COMPLETED
5317851,1,1,1704295431,1704295431,1704295476,45,COMPLETED
5317852,1,1,1704295431,1704295431,1704295482,51,COMPLETED
5317853,1,1,1704295431,1704295431,1704295484,53,COMPLETED
5317854,1,1,1704295431,1704295432,1704295481,49,COMPLETED
5317855,1,1,1704295432,1704295433,1704295486,53,COMPLETED
5317856,1,1,1704295432,1704295433,1704295484,51,COMPLETED
5317857,1,1,1704295432,1704295433,1704295483,50,COMPLETED
5317858,1,1,1704295432,1704295433,1704295485,52,COMPLETED
5317859,1,1,1704295432,1704295433,1704295484,51,COMPLETED
5317860,1,1,1704295432,1704295433,1704295485,52,COMPLETED
5317861,1,1,1704295432,1704295433,1704295486,53,COMPLETED
5317862,1,1,1704295432,1704295433,1704295482,49,COMPLETED
5317863,1,1,1704295432,1704295433,1704295480,47,COMPLETED
5317864,1,1,1704295432,1704295433,1704295480,47,COMPLETED
5317865,1,1,1704295433,1704295434,1704295486,52,COMPLETED
5317866,1,1,1704295433,1704295434,1704295486,52,COMPLETED
5317867,1,1,1704295433,1704295434,1704295482,48,COMPLETED
5317868,1,1,1704295433,1704295434,1704295484,50,COMPLETED
5317869,1,1,1704295433,1704295434,1704295480,46,COMPLETED
5317870,1,1,1704295433,1704295434,1704295483,49,COMPLETED
5317871,1,1,1704295433,1704295434,1704295484,50,COMPLETED
5317872,1,1,1704295433,1704295434,1704295481,47,COMPLETED
5317873,1,1,1704295433,1704295434,1704295485,51,COMPLETED
5317874,1,1,1704295434,1704295435,1704295483,48,COMPLETED
5317875,1,1,1704295434,1704295435,1704295483,48,COMPLETED
5317876,1,1,1704295434,1704295435,1704295485,50,COMPLETED
5317877,1,1,1704295434,1704295435,1704295485,50,COMPLETED
5317878,1,1,1704295434,1704295435,1704295486,51,COMPLETED
5317879,1,1,1704295434,1704295435,1704295480,45,COMPLETED
5317880,1,1,1704295434,1704295435,1704295486,51,COMPLETED
5317881,1,1,1704295434,1704295435,1704295483,48,COMPLETED
5317882,1,1,1704295435,1704295435,1704295490,55,COMPLETED
5317883,1,1,1704295435,1704295435,1704295482,47,COMPLETED
5317884,1,1,1704295435,1704295435,1704295483,48,COMPLETED
5317885,1,1,1704295435,1704295435,1704295485,50,COMPLETED
5317886,1,1,1704295435,1704295435,1704295484,49,COMPLETED
5317887,1,1,1704295435,1704295435,1704295483,48,COMPLETED
5317888,1,1,1704295435,1704295435,1704295483,48,COMPLETED
5317889,1,1,1704295435,1704295435,1704295483,48,COMPLETED
5317890,1,1,1704295435,1704295435,1704295484,49,COMPLETED
5317891,1,1,1704295435,1704295437,1704295482,45,COMPLETED
5317892,1,1,1704295435,1704295437,1704295483,46,COMPLETED
5317893,1,1,1704295436,1704295437,1704295485,48,COMPLETED
5317894,1,1,1704295436,1704295437,1704295483,46,COMPLETED
5317895,1,1,1704295436,1704295437,1704295491,54,COMPLETED
5317896,1,1,1704295436,1704295437,1704295485,48,COMPLETED
5317897,1,1,1704295436,1704295437,1704295485,48,COMPLETED
5317898,1,1,1704295436,1704295437,1704295484,47,COMPLETED
5317899,1,1,1704295436,1704295437,1704295484,47,COMPLETED
5317900,1,1,1704295436,1704295437,1704295480,43,COMPLETED
5317901,1,1,1704295436,1704295437,1704295482,45,COMPLETED
5317902,1,1,1704295436,1704295437,1704295483,46,COMPLETED
5317903,1,1,1704295437,1704295439,1704295483,44,COMPLETED
5317904,1,1,1704295437,1704295439,1704295480,41,COMPLETED
5317905,1,1,1704295437,1704295439,1704295483,44,COMPLETED
5317906,1,1,1704295437,1704295439,1704295482,43,COMPLETED
5317907,1,1,1704295437,1704295439,1704295483,44,COMPLETED
5317908,1,1,1704295437,1704295439,1704295483,44,COMPLETED
5317909,1,1,1704295437,1704295439,1704295483,44,COMPLETED
5317910,1,1,1704295437,1704295439,1704295485,46,COMPLETED
5317911,1,1,1704295437,1704295439,1704295486,47,COMPLETED
5317912,1,1,1704295437,1704295439,1704295483,44,COMPLETED
5317913,1,1,1704295438,1704295439,1704295484,45,COMPLETED
5317914,1,1,1704295438,1704295439,1704295483,44,COMPLETED
5317915,1,1,1704295438,1704295439,1704295485,46,COMPLETED
5317916,1,1,1704295438,1704295439,1704295484,45,COMPLETED
5317917,1,1,1704295438,1704295439,1704295480,41,COMPLETED
5317918,1,1,1704295438,1704295439,1704295489,50,COMPLETED
5317919,1,1,1704295438,1704295439,1704295484,45,COMPLETED
5317920,1,1,1704295438,1704295439,1704295484,45,COMPLETED
5317921,1,1,1704295438,1704295439,1704295487,48,COMPLETED
5317922,1,1,1704295438,1704295439,1704295483,44,COMPLETED
5317923,1,1,1704295439,1704295439,1704295483,44,COMPLETED
5317924,1,1,1704295439,1704295439,1704295477,38,COMPLETED
5317925,1,1,1704295439,1704295439,1704295476,37,COMPLETED
5317926,1,1,1704295439,1704295439,1704295476,37,COMPLETED
5317927,1,1,1704295439,1704295439,1704295478,39,COMPLETED
5317928,1,1,1704295439,1704295439,1704295476,37,COMPLETED
5317929,1,1,1704295439,1704295439,1704295476,37,COMPLETED
5317930,1,1,1704295439,1704295439,1704295477,38,COMPLETED
5317931,1,1,1704295439,1704295439,1704295478,39,COMPLETED
5317932,1,1,1704295439,1704295442,1704295478,36,COMPLETED
5317933,1,1,1704295440,1704295442,1704295478,36,COMPLETED
5317934,1,1,1704295440,1704295442,1704295480,38,COMPLETED
5317935,1,1,1704295440,1704295442,1704295477,35,COMPLETED
5317936,1,1,1704295440,1704295442,1704295477,35,COMPLETED
5317937,1,1,1704295440,1704295442,1704295476,34,COMPLETED
5317938,1,1,1704295440,1704295442,1704295475,33,COMPLETED
5317939,1,1,1704295440,1704295442,1704295476,34,COMPLETED
5317940,1,1,1704295441,1704295442,1704295476,34,COMPLETED
5317941,1,1,1704295441,1704295442,1704295477,35,COMPLETED
5317942,1,1,1704295441,1704295442,1704295477,35,COMPLETED
5317943,1,1,1704295441,1704295442,1704295475,33,COMPLETED
5317944,1,1,1704295441,1704295442,1704295475,33,COMPLETED
5317945,1,1,1704295441,1704295442,1704295475,33,COMPLETED
5317946,1,1,1704295441,1704295442,1704295475,33,COMPLETED
5317947,1,1,1704295441,1704295442,1704295475,33,COMPLETED
5317948,1,1,1704295441,1704295442,1704295486,44,COMPLETED
5317949,1,1,1704295441,1704295442,1704295475,33,COMPLETED
5317950,1,1,1704295441,1704295442,1704295475,33,COMPLETED
5317951,1,1,1704295443,1704295443,1704295475,32,COMPLETED
5317952,1,1,1704295443,1704295443,1704295475,32,COMPLETED
5317953,1,1,1704295443,1704295443,1704295478,35,COMPLETED
5317954,1,1,1704295467,1704295468,1704295514,46,COMPLETED
5317955,1,1,1704295468,1704295468,1704295507,39,COMPLETED
5317956,1,1,1704295468,1704295472,1704295507,35,COMPLETED
5317957,1,1,1704295471,1704295472,1704295507,35,COMPLETED
5317958,1,1,1704295471,1704295472,1704295509,37,COMPLETED
5317959,1,1,1704295471,1704295472,1704295507,35,COMPLETED
5317960,1,1,1704295471,1704295472,1704295507,35,COMPLETED
5317961,1,1,1704295471,1704295472,1704295509,37,COMPLETED
5317962,1,1,1704295471,1704295472,1704295508,36,COMPLETED
5317963,1,1,1704295471,1704295472,1704295507,35,COMPLETED
5317964,1,1,1704295471,1704295472,1704295508,36,COMPLETED
5317965,1,1,1704295471,1704295472,1704295508,36,COMPLETED
5317966,1,1,1704295472,1704295472,1704295508,36,COMPLETED
5317967,1,1,1704295472,1704295472,1704295509,37,COMPLETED
5317968,1,1,1704295472,1704295472,1704295507,35,COMPLETED
5317969,1,1,1704295472,1704295472,1704295508,36,COMPLETED
5317970,1,1,1704295472,1704295472,1704295511,39,COMPLETED
5317971,1,1,1704295472,1704295472,1704295516,44,COMPLETED
5317972,1,1,1704295472,1704295472,1704295511,39,COMPLETED
5317973,1,1,1704295472,1704295472,1704295507,35,COMPLETED
5317974,1,1,1704295472,1704295472,1704295509,37,COMPLETED
5317975,1,1,1704295472,1704295472,1704295515,43,COMPLETED
5317976,1,1,1704295472,1704295472,1704295507,35,COMPLETED
5317977,1,1,1704295472,1704295472,1704295507,35,COMPLETED
5317978,1,1,1704295473,1704295476,1704295516,40,COMPLETED
5317979,1,1,1704295473,1704295476,1704295516,40,COMPLETED
5317980,1,1,1704295473,1704295476,1704295510,34,COMPLETED
5317981,1,1,1704295473,1704295476,1704295512,36,COMPLETED
5317982,1,1,1704295473,1704295476,1704295510,34,COMPLETED
5317983,1,1,1704295473,1704295476,1704295516,40,COMPLETED
5317984,1,1,1704295473,1704295476,1704295516,40,COMPLETED
5317985,1,1,1704295473,1704295476,1704295509,33,COMPLETED
5317986,1,1,1704295473,1704295476,1704295511,35,COMPLETED
5317987,1,1,1704295473,1704295476,1704295516,40,COMPLETED
5317988,1,1,1704295473,1704295476,1704295512,36,COMPLETED
5317989,1,1,1704295473,1704295476,1704295510,34,COMPLETED
5317990,1,1,1704295473,1704295476,1704295511,35,COMPLETED
5317991,1,1,1704295473,1704295476,1704295519,43,COMPLETED
5317992,1,1,1704295473,1704295476,1704295511,35,COMPLETED
5317993,1,1,1704295474,1704295476,1704295510,34,COMPLETED
5317994,1,1,1704295474,1704295476,1704295515,39,COMPLETED
5317995,1,1,1704295474,1704295476,1704295510,34,COMPLETED
5317996,1,1,1704295474,1704295476,1704295512,36,COMPLETED
5317997,1,1,1704295474,1704295476,1704295511,35,COMPLETED
5317998,1,1,1704295474,1704295476,1704295509,33,COMPLETED
5317999,1,1,1704295474,1704295476,1704295511,35,COMPLETED
5318000,1,1,1704295474,1704295476,1704295513,37,COMPLETED
5318001,1,1,1704295474,1704295476,1704295510,34,COMPLETED
5318002,1,1,1704295474,1704295476,1704295511,35,COMPLETED
5318003,1,1,1704295474,1704295476,1704295512,36,COMPLETED
5318004,1,1,1704295474,1704295476,1704295518,42,COMPLETED
5318005,1,1,1704295486,1704295486,1704295510,24,COMPLETED
5318006,1,1,1704295486,1704295486,1704295510,24,COMPLETED
5318007,1,1,1704295486,1704295486,1704295510,24,COMPLETED
5318008,1,1,1704295486,1704295486,1704295517,31,COMPLETED
5318009,1,1,1704295486,1704295486,1704295510,24,COMPLETED
5318010,1,1,1704295539,1704295540,1704295545,5,COMPLETED
5318012,1,1,1704295539,1704295569,1704295573,4,COMPLETED
5318014,1,1,1704295597,1704295598,1704295649,51,COMPLETED
5318015,1,1,1704295597,1704295598,1704295649,51,COMPLETED
5318016,1,1,1704295597,1704295598,1704295649,51,COMPLETED
5318017,1,1,1704295597,1704295598,1704295649,51,COMPLETED
5318018,1,1,1704295597,1704295598,1704295649,51,COMPLETED
5318019,1,1,1704295597,1704295598,1704295649,51,COMPLETED
5318020,1,1,1704295597,1704295598,1704295649,51,COMPLETED
5318021,1,1,1704295597,1704295598,1704295649,51,COMPLETED
5318022,1,1,1704295597,1704295598,1704295652,54,COMPLETED
5318023,1,1,1704295597,1704295598,1704295649,51,COMPLETED
5318024,1,1,1704295597,1704295598,1704295649,51,COMPLETED
5318025,1,1,1704295597,1704295598,1704295649,51,COMPLETED
5318026,1,1,1704295597,1704295598,1704295651,53,COMPLETED
5318027,1,1,1704295597,1704295598,1704295649,51,COMPLETED
5318028,1,1,1704295597,1704295598,1704295650,52,COMPLETED
5318029,1,1,1704295597,1704295598,1704295649,51,COMPLETED
5318030,1,1,1704295597,1704295598,1704295649,51,COMPLETED
5318031,1,1,1704295597,1704295598,1704295653,55,COMPLETED
5318032,1,1,1704295597,1704295598,1704295649,51,COMPLETED
5318033,1,1,1704295597,1704295598,1704295649,51,COMPLETED
5318034,1,1,1704295598,1704295598,1704295649,51,COMPLETED
5318035,1,1,1704295598,1704295598,1704295649,51,COMPLETED
5318036,1,1,1704295598,1704295598,1704295649,51,COMPLETED
5318037,1,1,1704295598,1704295598,1704295649,51,COMPLETED
5318038,1,1,1704295598,1704295602,1704295649,47,COMPLETED
5318039,1,1,1704295598,1704295602,1704295657,55,COMPLETED
5318040,1,1,1704295598,1704295602,1704295649,47,COMPLETED
5318041,1,1,1704295598,1704295602,1704295651,49,COMPLETED
5318042,1,1,1704295598,1704295602,1704295649,47,COMPLETED
5318043,1,1,1704295598,1704295602,1704295649,47,COMPLETED
5318044,1,1,1704295598,1704295602,1704295649,47,COMPLETED
5318045,1,1,1704295598,1704295602,1704295656,54,COMPLETED
5318046,1,1,1704295598,1704295602,1704295652,50,COMPLETED
5318047,1,1,1704295598,1704295602,1704295649,47,COMPLETED
5318048,1,1,1704295598,1704295602,1704295651,49,COMPLETED
5318049,1,1,1704295598,1704295602,1704295649,47,COMPLETED
5318050,1,1,1704295598,1704295602,1704295649,47,COMPLETED
5318051,1,1,1704295599,1704295602,1704295650,48,COMPLETED
5318052,1,1,1704295599,1704295602,1704295649,47,COMPLETED
5318053,1,1,1704295599,1704295602,1704295649,47,COMPLETED
5318054,1,1,1704295599,1704295602,1704295649,47,COMPLETED
5318055,1,1,1704295599,1704295602,1704295649,47,COMPLETED
5318056,1,1,1704295599,1704295602,1704295652,50,COMPLETED
5318057,1,1,1704295599,1704295602,1704295649,47,COMPLETED
5318058,1,1,1704295599,1704295602,1704295649,47,COMPLETED
5318059,1,1,1704295599,1704295602,1704295650,48,COMPLETED
5318060,1,1,1704295599,1704295602,1704295649,47,COMPLETED
5318061,1,1,1704295599,1704295602,1704295649,47,COMPLETED
5318062,1,1,1704295599,1704295602,1704295656,54,COMPLETED
5318063,1,1,1704295599,1704295602,1704295649,47,COMPLETED
5318064,1,1,1704295599,1704295602,1704295649,47,COMPLETED
5318065,1,1,1704295599,1704295602,1704295649,47,COMPLETED
5318066,1,1,1704295599,1704295602,1704295652,50,COMPLETED
5318067,1,1,1704295599,1704295602,1704295652,50,COMPLETED
5318068,1,1,1704295599,1704295602,1704295654,52,COMPLETED
5318069,1,1,1704295599,1704295602,1704295649,47,COMPLETED
5318070,1,1,1704295599,1704295602,1704295649,47,COMPLETED
5318071,1,1,1704295599,1704295602,1704295650,48,COMPLETED
5318072,1,1,1704295599,1704295602,1704295649,47,COMPLETED
5318073,1,1,1704295599,1704295602,1704295653,51,COMPLETED
5318074,1,1,1704295599,1704295602,1704295649,47,COMPLETED
5318075,1,1,1704295599,1704295602,1704295657,55,COMPLETED
5318076,1,1,1704295599,1704295602,1704295649,47,COMPLETED
5318077,1,1,1704295599,1704295602,1704295649,47,COMPLETED
5318078,1,1,1704295599,1704295602,1704295654,52,COMPLETED
5318079,1,1,1704295599,1704295602,1704295649,47,COMPLETED
5318080,1,1,1704295600,1704295602,1704295650,48,COMPLETED
5318081,1,1,1704295600,1704295602,1704295649,47,COMPLETED
5318082,1,1,1704295600,1704295602,1704295649,47,COMPLETED
5318083,1,1,1704295600,1704295602,1704295650,48,COMPLETED
5318084,1,1,1704295600,1704295602,1704295649,47,COMPLETED
5318085,1,1,1704295600,1704295602,1704295656,54,COMPLETED
5318086,1,1,1704295600,1704295602,1704295649,47,COMPLETED
5318087,1,1,1704295600,1704295602,1704295649,47,COMPLETED
5318088,1,1,1704295600,1704295602,1704295649,47,COMPLETED
5318089,1,1,1704295600,1704295602,1704295649,47,COMPLETED
5318090,1,1,1704295600,1704295602,1704295649,47,COMPLETED
5318091,1,1,1704295600,1704295602,1704295649,47,COMPLETED
5318092,1,1,1704295600,1704295602,1704295649,47,COMPLETED
5318093,1,1,1704295600,1704295602,1704295655,53,COMPLETED
5318094,1,1,1704295600,1704295602,1704295649,47,COMPLETED
5318095,1,1,1704295600,1704295602,1704295650,48,COMPLETED
5318096,1,1,1704295600,1704295602,1704295652,50,COMPLETED
5318097,1,1,1704295600,1704295602,1704295650,48,COMPLETED
5318098,1,1,1704295600,1704295602,1704295651,49,COMPLETED
5318099,1,1,1704295600,1704295602,1704295649,47,COMPLETED
5318100,1,1,1704295600,1704295602,1704295649,47,COMPLETED
5318101,1,1,1704295600,1704295602,1704295649,47,COMPLETED
5318102,1,1,1704295601,1704295602,1704295650,48,COMPLETED
5318103,1,1,1704295601,1704295602,1704295650,48,COMPLETED
5318104,1,1,1704295601,1704295602,1704295649,47,COMPLETED
5318105,1,1,1704295601,1704295602,1704295649,47,COMPLETED
5318106,1,1,1704295601,1704295602,1704295649,47,COMPLETED
5318107,1,1,1704295601,1704295602,1704295649,47,COMPLETED
5318108,1,1,1704295601,1704295602,1704295652,50,COMPLETED
5318109,1,1,1704295601,1704295602,1704295649,47,COMPLETED
5318110,1,1,1704295601,1704295602,1704295649,47,COMPLETED
5318111,1,1,1704295601,1704295602,1704295649,47,COMPLETED
5318112,1,1,1704295601,1704295602,1704295649,47,COMPLETED
5318113,1,1,1704295601,1704295602,1704295649,47,COMPLETED
5318114,1,1,1704295601,1704295602,1704295649,47,COMPLETED
5318115,1,1,1704295601,1704295602,1704295652,50,COMPLETED
5318116,1,1,1704295601,1704295602,1704295657,55,COMPLETED
5318117,1,1,1704295601,1704295602,1704295649,47,COMPLETED
5318118,1,1,1704295601,1704295602,1704295649,47,COMPLETED
5318119,1,1,1704295601,1704295602,1704295652,50,COMPLETED
5318120,1,1,1704295601,1704295602,1704295652,50,COMPLETED
5318121,1,1,1704295601,1704295602,1704295649,47,COMPLETED
5318122,1,1,1704295601,1704295602,1704295649,47,COMPLETED
5318123,1,1,1704295601,1704295602,1704295649,47,COMPLETED
5318124,1,1,1704295601,1704295602,1704295650,48,COMPLETED
5318125,1,1,1704295601,1704295602,1704295649,47,COMPLETED
5318126,1,1,1704295601,1704295602,1704295650,48,COMPLETED
5318127,1,1,1704295601,1704295602,1704295650,48,COMPLETED
5318128,1,1,1704295601,1704295602,1704295649,47,COMPLETED
5318129,1,1,1704295601,1704295602,1704295650,48,COMPLETED
5318130,1,1,1704295601,1704295602,1704295650,48,COMPLETED
5318131,1,1,1704295601,1704295602,1704295649,47,COMPLETED
5318132,1,1,1704295601,1704295602,1704295649,47,COMPLETED
5318133,1,1,1704295601,1704295602,1704295649,47,COMPLETED
5318134,1,1,1704295601,1704295602,1704295649,47,COMPLETED
5318135,1,1,1704295602,1704295602,1704295649,47,COMPLETED
5318136,1,1,1704295602,1704295602,1704295656,54,COMPLETED
5318137,1,1,1704295602,1704295602,1704295649,47,COMPLETED
5318138,1,1,1704295602,1704295602,1704295649,47,COMPLETED
5318139,1,1,1704295602,1704295602,1704295649,47,COMPLETED
5318140,1,1,1704295602,1704295602,1704295649,47,COMPLETED
5318141,1,1,1704295602,1704295602,1704295649,47,COMPLETED
5318142,1,1,1704295602,1704295602,1704295649,47,COMPLETED
5318143,1,1,1704295602,1704295602,1704295650,48,COMPLETED
5318144,1,1,1704295602,1704295602,1704295649,47,COMPLETED
5318145,1,1,1704295602,1704295602,1704295649,47,COMPLETED
5318146,1,1,1704295602,1704295602,1704295650,48,COMPLETED
5318147,1,1,1704295602,1704295602,1704295652,50,COMPLETED
5318148,1,1,1704295602,1704295602,1704295649,47,COMPLETED
5318149,1,1,1704295602,1704295606,1704295649,43,COMPLETED
5318150,1,1,1704295602,1704295606,1704295649,43,COMPLETED
5318151,1,1,1704295602,1704295606,1704295649,43,COMPLETED
5318152,1,1,1704295602,1704295606,1704295649,43,COMPLETED
5318153,1,1,1704295603,1704295606,1704295649,43,COMPLETED
5318154,1,1,1704295603,1704295606,1704295649,43,COMPLETED
5318155,1,1,1704295603,1704295606,1704295649,43,COMPLETED
5318156,1,1,1704295603,1704295606,1704295650,44,COMPLETED
5318157,1,1,1704295603,1704295606,1704295651,45,COMPLETED
5318158,1,1,1704295603,1704295606,1704295653,47,COMPLETED
5318159,1,1,1704295603,1704295606,1704295652,46,COMPLETED
5318160,1,1,1704295603,1704295606,1704295650,44,COMPLETED
5318161,1,1,1704295603,1704295606,1704295649,43,COMPLETED
5318162,1,1,1704295603,1704295606,1704295649,43,COMPLETED
5318163,1,1,1704295603,1704295606,1704295649,43,COMPLETED
5318164,1,1,1704295603,1704295606,1704295649,43,COMPLETED
5318165,1,1,1704295603,1704295606,1704295649,43,COMPLETED
5318166,1,1,1704295603,1704295606,1704295649,43,COMPLETED
5318167,1,1,1704295603,1704295606,1704295650,44,COMPLETED
5318168,1,1,1704295603,1704295606,1704295649,43,COMPLETED
5318169,1,1,1704295603,1704295606,1704295652,46,COMPLETED
5318170,1,1,1704295603,1704295606,1704295649,43,COMPLETED
5318171,1,1,1704295603,1704295606,1704295649,43,COMPLETED
5318172,1,1,1704295603,1704295606,1704295649,43,COMPLETED
5318173,1,1,1704295604,1704295606,1704295649,43,COMPLETED
5318174,1,1,1704295604,1704295606,1704295649,43,COMPLETED
5318175,1,1,1704295604,1704295606,1704295650,44,COMPLETED
5318176,1,1,1704295604,1704295606,1704295650,44,COMPLETED
5318177,1,1,1704295604,1704295606,1704295649,43,COMPLETED
5318178,1,1,1704295604,1704295606,1704295649,43,COMPLETED
5318179,1,1,1704295604,1704295606,1704295649,43,COMPLETED
5318180,1,1,1704295604,1704295606,1704295649,43,COMPLETED
5318181,1,1,1704295604,1704295606,1704295649,43,COMPLETED
5318182,1,1,1704295604,1704295606,1704295649,43,COMPLETED
5318183,1,1,1704295604,1704295606,1704295649,43,COMPLETED
5318184,1,1,1704295604,1704295606,1704295649,43,COMPLETED
5318185,1,1,1704295604,1704295606,1704295649,43,COMPLETED
5318186,1,1,1704295604,1704295606,1704295655,49,COMPLETED
5318187,1,1,1704295604,1704295606,1704295649,43,COMPLETED
5318188,1,1,1704295604,1704295606,1704295649,43,COMPLETED
5318189,1,1,1704295604,1704295606,1704295650,44,COMPLETED
5318190,1,1,1704295604,1704295606,1704295649,43,COMPLETED
5318191,1,1,1704295604,1704295606,1704295649,43,COMPLETED
5318192,1,1,1704295604,1704295606,1704295651,45,COMPLETED
5318193,1,1,1704295604,1704295606,1704295649,43,COMPLETED
5318194,1,1,1704295604,1704295606,1704295649,43,COMPLETED
5318195,1,1,1704295604,1704295606,1704295649,43,COMPLETED
5318196,1,1,1704295604,1704295606,1704295649,43,COMPLETED
5318197,1,1,1704295604,1704295606,1704295649,43,COMPLETED
5318198,1,1,1704295604,1704295606,1704295649,43,COMPLETED
5318199,1,1,1704295604,1704295606,1704295649,43,COMPLETED
5318200,1,1,1704295604,1704295606,1704295649,43,COMPLETED
5318201,1,1,1704295604,1704295606,1704295650,44,COMPLETED
5318202,1,1,1704295604,1704295606,1704295649,43,COMPLETED
5318203,1,1,1704295604,1704295606,1704295649,43,COMPLETED
5318204,1,1,1704295604,1704295606,1704295649,43,COMPLETED
5318205,1,1,1704295604,1704295606,1704295650,44,COMPLETED
5318206,1,1,1704295604,1704295606,1704295649,43,COMPLETED
5318207,1,1,1704295604,1704295606,1704295653,47,COMPLETED
5318208,1,1,1704295604,1704295606,1704295650,44,COMPLETED
5318209,1,1,1704295604,1704295606,1704295649,43,COMPLETED
5318210,1,1,1704295604,1704295606,1704295649,43,COMPLETED
5318211,1,1,1704295604,1704295606,1704295649,43,COMPLETED
5318212,1,1,1704295604,1704295606,1704295649,43,COMPLETED
5318213,1,1,1704295604,1704295606,1704295649,43,COMPLETED
5318214,1,1,1704295659,1704295660,1704295700,40,COMPLETED
5318215,1,1,1704295659,1704295660,1704295701,41,COMPLETED
5318216,1,1,1704295659,1704295660,1704295701,41,COMPLETED
5318217,1,1,1704295659,1704295660,1704295700,40,COMPLETED
5318218,1,1,1704295659,1704295660,1704295701,41,COMPLETED
5318219,1,1,1704295659,1704295660,1704295699,39,COMPLETED
5318220,1,1,1704295659,1704295660,1704295699,39,COMPLETED
5318221,1,1,1704295659,1704295660,1704295707,47,COMPLETED
5318222,1,1,1704295660,1704295660,1704295700,40,COMPLETED
5318223,1,1,1704295660,1704295664,1704295700,36,COMPLETED
5318224,1,1,1704295660,1704295664,1704295701,37,COMPLETED
5318225,1,1,1704295660,1704295664,1704295699,35,COMPLETED
5318226,1,1,1704295660,1704295664,1704295701,37,COMPLETED
5318227,1,1,1704295660,1704295664,1704295698,34,COMPLETED
5318228,1,1,1704295660,1704295664,1704295699,35,COMPLETED
5318229,1,1,1704295660,1704295664,1704295701,37,COMPLETED
5318230,1,1,1704295660,1704295664,1704295700,36,COMPLETED
5318231,1,1,1704295660,1704295664,1704295701,37,COMPLETED
5318232,1,1,1704295660,1704295664,1704295700,36,COMPLETED
5318233,1,1,1704295660,1704295664,1704295711,47,COMPLETED
5318234,1,1,1704295661,1704295664,1704295701,37,COMPLETED
5318235,1,1,1704295661,1704295664,1704295699,35,COMPLETED
5318236,1,1,1704295661,1704295664,1704295701,37,COMPLETED
5318237,1,1,1704295661,1704295664,1704295698,34,COMPLETED
5318238,1,1,1704295661,1704295664,1704295699,35,COMPLETED
5318239,1,1,1704295661,1704295664,1704295711,47,COMPLETED
5318240,1,1,1704295661,1704295664,1704295699,35,COMPLETED
5318241,1,1,1704295661,1704295664,1704295700,36,COMPLETED
5318242,1,1,1704295661,1704295664,1704295698,34,COMPLETED
5318243,1,1,1704295661,1704295664,1704295698,34,COMPLETED
5318244,1,1,1704295662,1704295664,1704295701,37,COMPLETED
5318245,1,1,1704295662,1704295664,1704295699,35,COMPLETED
5318246,1,1,1704295662,1704295664,1704295699,35,COMPLETED
5318247,1,1,1704295662,1704295664,1704295699,35,COMPLETED
5318248,1,1,1704295662,1704295664,1704295700,36,COMPLETED
5318249,1,1,1704295662,1704295664,1704295701,37,COMPLETED
5318250,1,1,1704295662,1704295664,1704295702,38,COMPLETED
5318251,1,1,1704295662,1704295664,1704295698,34,COMPLETED
5318252,1,1,1704295662,1704295664,1704295698,34,COMPLETED
5318253,1,1,1704295662,1704295664,1704295699,35,COMPLETED
5318254,1,1,1704295663,1704295664,1704295700,36,COMPLETED
5318255,1,1,1704295663,1704295664,1704295702,38,COMPLETED
5318256,1,1,1704295663,1704295664,1704295702,38,COMPLETED
5318257,1,1,1704295663,1704295664,1704295697,33,COMPLETED
5318258,1,1,1704295663,1704295664,1704295698,34,COMPLETED
5318259,1,1,1704295663,1704295664,1704295698,34,COMPLETED
5318260,1,1,1704295663,1704295664,1704295699,35,COMPLETED
5318261,1,1,1704295663,1704295664,1704295700,36,COMPLETED
5318262,1,1,1704295663,1704295664,1704295700,36,COMPLETED
5318263,1,1,1704295663,1704295664,1704295698,34,COMPLETED
5318264,1,1,1704295664,1704295664,1704295698,34,COMPLETED
5318265,1,1,1704295664,1704295668,1704295711,43,COMPLETED
5318266,1,1,1704295664,1704295668,1704295707,39,COMPLETED
5318267,1,1,1704295664,1704295668,1704295702,34,COMPLETED
5318268,1,1,1704295664,1704295668,1704295699,31,COMPLETED
5318269,1,1,1704295664,1704295668,1704295699,31,COMPLETED
5318270,1,1,1704295665,1704295668,1704295699,31,COMPLETED
5318271,1,1,1704295665,1704295668,1704295698,30,COMPLETED
5318272,1,1,1704295665,1704295668,1704295698,30,COMPLETED
5318273,1,1,1704295665,1704295668,1704295700,32,COMPLETED
5318274,1,1,1704295665,1704295668,1704295702,34,COMPLETED
5318275,1,1,1704295665,1704295668,1704295698,30,COMPLETED
5318276,1,1,1704295665,1704295668,1704295699,31,COMPLETED
5318277,1,1,1704295665,1704295668,1704295698,30,COMPLETED
5318278,1,1,1704295665,1704295668,1704295698,30,COMPLETED
5318279,1,1,1704295665,1704295668,1704295697,29,COMPLETED
5318280,1,1,1704295665,1704295668,1704295699,31,COMPLETED
5318281,1,1,1704295665,1704295668,1704295699,31,COMPLETED
5318282,1,1,1704295665,1704295668,1704295702,34,COMPLETED
5318283,1,1,1704295665,1704295668,1704295699,31,COMPLETED
5318285,1,1,1704295666,1704295668,1704295700,32,COMPLETED
5318286,1,1,1704295666,1704295668,1704295698,30,COMPLETED
5318287,1,1,1704295666,1704295668,1704295697,29,COMPLETED
5318288,1,1,1704295666,1704295668,1704295697,29,COMPLETED
5318289,1,1,1704295666,1704295668,1704295697,29,COMPLETED
5318290,1,1,1704295666,1704295668,1704295698,30,COMPLETED
5318291,1,1,1704295666,1704295668,1704295697,29,COMPLETED
5318292,1,1,1704295666,1704295668,1704295697,29,COMPLETED
5318293,1,1,1704295666,1704295668,1704295698,30,COMPLETED
5318284,1,1,1704295666,1704295668,1704295843,175,COMPLETED
5318294,1,1,1704295667,1704295668,1704295697,29,COMPLETED
5318295,1,1,1704295667,1704295668,1704295698,30,COMPLETED
5318296,1,1,1704295667,1704295668,1704295697,29,COMPLETED
5318297,1,1,1704295667,1704295668,1704295698,30,COMPLETED
5318298,1,1,1704295667,1704295668,1704295697,29,COMPLETED
5318299,1,1,1704295667,1704295668,1704295697,29,COMPLETED
5318300,1,1,1704295667,1704295668,1704295698,30,COMPLETED
5318301,1,1,1704295667,1704295668,1704295698,30,COMPLETED
5318302,1,1,1704295667,1704295668,1704295697,29,COMPLETED
5318303,1,1,1704295667,1704295668,1704295712,44,COMPLETED
5318304,1,1,1704295668,1704295668,1704295698,30,COMPLETED
5318305,1,1,1704295668,1704295672,1704295715,43,COMPLETED
5318306,1,1,1704295668,1704295672,1704295715,43,COMPLETED
5318307,1,1,1704295668,1704295672,1704295712,40,COMPLETED
5318308,1,1,1704295668,1704295672,1704295715,43,COMPLETED
5318309,1,1,1704295668,1704295672,1704295712,40,COMPLETED
5318310,1,1,1704295668,1704295672,1704295715,43,COMPLETED
5318311,1,1,1704295668,1704295672,1704295712,40,COMPLETED
5318312,1,1,1704295668,1704295672,1704295712,40,COMPLETED
5318313,1,1,1704295668,1704295672,1704295712,40,COMPLETED
5318314,1,1,1704295669,1704295672,1704295715,43,COMPLETED
5318315,1,1,1704295669,1704295672,1704295712,40,COMPLETED
5318316,1,1,1704295669,1704295672,1704295712,40,COMPLETED
5318317,1,1,1704295669,1704295672,1704295712,40,COMPLETED
5318318,1,1,1704295669,1704295672,1704295712,40,COMPLETED
5318319,1,1,1704295669,1704295672,1704295715,43,COMPLETED
5318320,1,1,1704295669,1704295672,1704295712,40,COMPLETED
5318321,1,1,1704295669,1704295672,1704295712,40,COMPLETED
5318322,1,1,1704295669,1704295672,1704295721,49,COMPLETED
5318323,1,1,1704295669,1704295672,1704295719,47,COMPLETED
5318324,1,1,1704295670,1704295672,1704295722,50,COMPLETED
5318325,1,1,1704295670,1704295672,1704295727,55,COMPLETED
5318326,1,1,1704295670,1704295672,1704295716,44,COMPLETED
5318327,1,1,1704295670,1704295672,1704295721,49,COMPLETED
5318328,1,1,1704295670,1704295672,1704295716,44,COMPLETED
5318329,1,1,1704295670,1704295672,1704295716,44,COMPLETED
5318330,1,1,1704295670,1704295672,1704295718,46,COMPLETED
5318331,1,1,1704295670,1704295672,1704295716,44,COMPLETED
5318332,1,1,1704295670,1704295672,1704295716,44,COMPLETED
5318333,1,1,1704295670,1704295672,1704295716,44,COMPLETED
5318334,1,1,1704295671,1704295672,1704295717,45,COMPLETED
5318335,1,1,1704295671,1704295672,1704295717,45,COMPLETED
5318336,1,1,1704295671,1704295672,1704295717,45,COMPLETED
5318337,1,1,1704295671,1704295672,1704295721,49,COMPLETED
5318338,1,1,1704295671,1704295672,1704295718,46,COMPLETED
5318339,1,1,1704295671,1704295672,1704295716,44,COMPLETED
5318340,1,1,1704295671,1704295672,1704295718,46,COMPLETED
5318341,1,1,1704295671,1704295672,1704295715,43,COMPLETED
5318342,1,1,1704295671,1704295672,1704295721,49,COMPLETED
5318343,1,1,1704295671,1704295672,1704295717,45,COMPLETED
5318344,1,1,1704295672,1704295672,1704295719,47,COMPLETED
5318345,1,1,1704295672,1704295673,1704295717,44,COMPLETED
5318346,1,1,1704295672,1704295673,1704295717,44,COMPLETED
5318347,1,1,1704295672,1704295673,1704295715,42,COMPLETED
5318348,1,1,1704295672,1704295673,1704295719,46,COMPLETED
5318349,1,1,1704295672,1704295673,1704295715,42,COMPLETED
5318350,1,1,1704295672,1704295673,1704295718,45,COMPLETED
5318351,1,1,1704295672,1704295673,1704295719,46,COMPLETED
5318352,1,1,1704295672,1704295673,1704295727,54,COMPLETED
5318353,1,1,1704295672,1704295673,1704295715,42,COMPLETED
5318354,1,1,1704295673,1704295676,1704295728,52,COMPLETED
5318355,1,1,1704295673,1704295676,1704295718,42,COMPLETED
5318356,1,1,1704295673,1704295676,1704295721,45,COMPLETED
5318357,1,1,1704295673,1704295676,1704295717,41,COMPLETED
5318358,1,1,1704295673,1704295676,1704295725,49,COMPLETED
5318359,1,1,1704295673,1704295676,1704295725,49,COMPLETED
5318360,1,1,1704295673,1704295676,1704295731,55,COMPLETED
5318361,1,1,1704295674,1704295676,1704295726,50,COMPLETED
5318362,1,1,1704295674,1704295676,1704295727,51,COMPLETED
5318363,1,1,1704295674,1704295676,1704295725,49,COMPLETED
5318364,1,1,1704295674,1704295676,1704295728,52,COMPLETED
5318365,1,1,1704295674,1704295676,1704295723,47,COMPLETED
5318366,1,1,1704295674,1704295676,1704295725,49,COMPLETED
5318367,1,1,1704295674,1704295676,1704295725,49,COMPLETED
5318368,1,1,1704295674,1704295676,1704295725,49,COMPLETED
5318369,1,1,1704295674,1704295676,1704295727,51,COMPLETED
5318370,1,1,1704295674,1704295676,1704295725,49,COMPLETED
5318371,1,1,1704295674,1704295676,1704295726,50,COMPLETED
5318372,1,1,1704295674,1704295676,1704295725,49,COMPLETED
5318373,1,1,1704295674,1704295676,1704295725,49,COMPLETED
5318374,1,1,1704295675,1704295676,1704295723,47,COMPLETED
5318375,1,1,1704295675,1704295676,1704295723,47,COMPLETED
5318376,1,1,1704295675,1704295676,1704295723,47,COMPLETED
5318377,1,1,1704295675,1704295676,1704295726,50,COMPLETED
5318378,1,1,1704295675,1704295676,1704295725,49,COMPLETED
5318379,1,1,1704295675,1704295676,1704295722,46,COMPLETED
5318380,1,1,1704295675,1704295676,1704295723,47,COMPLETED
5318381,1,1,1704295676,1704295676,1704295727,51,COMPLETED
5318382,1,1,1704295676,1704295676,1704295723,47,COMPLETED
5318383,1,1,1704295676,1704295676,1704295725,49,COMPLETED
5318384,1,1,1704295676,1704295680,1704295736,56,COMPLETED
5318385,1,1,1704295676,1704295680,1704295736,56,COMPLETED
5318386,1,1,1704295676,1704295680,1704295735,55,COMPLETED
5318387,1,1,1704295676,1704295680,1704295736,56,COMPLETED
5318388,1,1,1704295676,1704295680,1704295736,56,COMPLETED
5318389,1,1,1704295676,1704295680,1704295736,56,COMPLETED
5318390,1,1,1704295676,1704295680,1704295735,55,COMPLETED
5318391,1,1,1704295677,1704295680,1704295736,56,COMPLETED
5318392,1,1,1704295677,1704295680,1704295742,62,COMPLETED
5318393,1,1,1704295677,1704295680,1704295737,57,COMPLETED
5318394,1,1,1704295677,1704295680,1704295737,57,COMPLETED
5318395,1,1,1704295677,1704295680,1704295738,58,COMPLETED
5318396,1,1,1704295677,1704295680,1704295737,57,COMPLETED
5318397,1,1,1704295677,1704295680,1704295737,57,COMPLETED
5318398,1,1,1704295677,1704295680,1704295737,57,COMPLETED
5318399,1,1,1704295677,1704295680,1704295736,56,COMPLETED
5318400,1,1,1704295677,1704295680,1704295737,57,COMPLETED
5318401,1,1,1704295677,1704295680,1704295736,56,COMPLETED
5318402,1,1,1704295678,1704295680,1704295736,56,COMPLETED
5318403,1,1,1704295678,1704295680,1704295738,58,COMPLETED
5318404,1,1,1704295678,1704295680,1704295738,58,COMPLETED
5318405,1,1,1704295678,1704295680,1704295738,58,COMPLETED
5318406,1,1,1704295678,1704295680,1704295738,58,COMPLETED
5318407,1,1,1704295678,1704295680,1704295738,58,COMPLETED
5318408,1,1,1704295679,1704295680,1704295738,58,COMPLETED
5318409,1,1,1704295679,1704295680,1704295738,58,COMPLETED
5318410,1,1,1704295679,1704295680,1704295736,56,COMPLETED
5318411,1,1,1704295679,1704295680,1704295741,61,COMPLETED
5318412,1,1,1704295679,1704295680,1704295739,59,COMPLETED
5318413,1,1,1704295679,1704295680,1704295739,59,COMPLETED
5318414,1,1,1704295717,1704295718,1704295776,58,COMPLETED
5318415,1,1,1704295717,1704295718,1704295777,59,COMPLETED
5318416,1,1,1704295718,1704295718,1704295778,60,COMPLETED
5318417,1,1,1704295718,1704295718,1704295773,55,COMPLETED
5318418,1,1,1704295718,1704295718,1704295771,53,COMPLETED
5318419,1,1,1704295718,1704295718,1704295773,55,COMPLETED
5318420,1,1,1704295718,1704295718,1704295774,56,COMPLETED
5318421,1,1,1704295718,1704295718,1704295777,59,COMPLETED
5318422,1,1,1704295718,1704295718,1704295776,58,COMPLETED
5318423,1,1,1704295718,1704295718,1704295774,56,COMPLETED
5318424,1,1,1704295718,1704295718,1704295771,53,COMPLETED
5318425,1,1,1704295718,1704295718,1704295774,56,COMPLETED
5318426,1,1,1704295719,1704295719,1704295775,56,COMPLETED
5318427,1,1,1704295719,1704295719,1704295775,56,COMPLETED
5318428,1,1,1704295719,1704295719,1704295773,54,COMPLETED
5318429,1,1,1704295719,1704295719,1704295775,56,COMPLETED
5318430,1,1,1704295719,1704295719,1704295770,51,COMPLETED
5318431,1,1,1704295719,1704295719,1704295776,57,COMPLETED
5318432,1,1,1704295719,1704295719,1704295773,54,COMPLETED
5318433,1,1,1704295719,1704295719,1704295774,55,COMPLETED
5318434,1,1,1704295719,1704295720,1704295776,56,COMPLETED
5318435,1,1,1704295719,1704295720,1704295771,51,COMPLETED
5318436,1,1,1704295720,1704295720,1704295773,53,COMPLETED
5318437,1,1,1704295720,1704295720,1704295775,55,COMPLETED
5318438,1,1,1704295720,1704295720,1704295770,50,COMPLETED
5318439,1,1,1704295720,1704295720,1704295774,54,COMPLETED
5318440,1,1,1704295720,1704295720,1704295774,54,COMPLETED
5318441,1,1,1704295720,1704295720,1704295775,55,COMPLETED
5318442,1,1,1704295720,1704295720,1704295774,54,COMPLETED
5318443,1,1,1704295720,1704295720,1704295775,55,COMPLETED
5318444,1,1,1704295720,1704295720,1704295775,55,COMPLETED
5318445,1,1,1704295720,1704295721,1704295775,54,COMPLETED
5318446,1,1,1704295720,1704295721,1704295774,53,COMPLETED
5318447,1,1,1704295720,1704295721,1704295770,49,COMPLETED
5318448,1,1,1704295720,1704295721,1704295777,56,COMPLETED
5318449,1,1,1704295721,1704295721,1704295773,52,COMPLETED
5318450,1,1,1704295721,1704295722,1704295773,51,COMPLETED
5318451,1,1,1704295721,1704295722,1704295770,48,COMPLETED
5318452,1,1,1704295721,1704295722,1704295770,48,COMPLETED
5318453,1,1,1704295721,1704295722,1704295770,48,COMPLETED
5318454,1,1,1704295721,1704295722,1704295770,48,COMPLETED
5318455,1,1,1704295722,1704295722,1704295770,48,COMPLETED
5318456,1,1,1704295722,1704295722,1704295770,48,COMPLETED
5318457,1,1,1704295722,1704295722,1704295770,48,COMPLETED
5318458,1,1,1704295722,1704295722,1704295770,48,COMPLETED
5318459,1,1,1704295722,1704295722,1704295770,48,COMPLETED
5318460,1,1,1704295722,1704295722,1704295770,48,COMPLETED
5318461,1,1,1704295722,1704295722,1704295770,48,COMPLETED
5318462,1,1,1704295722,1704295722,1704295770,48,COMPLETED
5318463,1,1,1704295722,1704295722,1704295770,48,COMPLETED
5318464,1,1,1704295722,1704295723,1704295770,47,COMPLETED
5318465,1,1,1704295722,1704295723,1704295776,53,COMPLETED
5318466,1,1,1704295723,1704295723,1704295778,55,COMPLETED
5318467,1,1,1704295723,1704295723,1704295773,50,COMPLETED
5318468,1,1,1704295723,1704295723,1704295773,50,COMPLETED
5318469,1,1,1704295723,1704295724,1704295773,49,COMPLETED
5318470,1,1,1704295723,1704295724,1704295773,49,COMPLETED
5318471,1,1,1704295723,1704295724,1704295777,53,COMPLETED
5318472,1,1,1704295723,1704295724,1704295777,53,COMPLETED
5318473,1,1,1704295723,1704295724,1704295772,48,COMPLETED
5318474,1,1,1704295723,1704295724,1704295773,49,COMPLETED
5318475,1,1,1704295723,1704295724,1704295773,49,COMPLETED
5318476,1,1,1704295723,1704295724,1704295774,50,COMPLETED
5318477,1,1,1704295723,1704295724,1704295770,46,COMPLETED
5318478,1,1,1704295724,1704295724,1704295777,53,COMPLETED
5318479,1,1,1704295724,1704295724,1704295774,50,COMPLETED
5318480,1,1,1704295724,1704295724,1704295774,50,COMPLETED
5318481,1,1,1704295724,1704295724,1704295777,53,COMPLETED
5318482,1,1,1704295724,1704295724,1704295776,52,COMPLETED
5318483,1,1,1704295724,1704295724,1704295774,50,COMPLETED
5318484,1,1,1704295724,1704295725,1704295770,45,COMPLETED
5318485,1,1,1704295725,1704295726,1704295772,46,COMPLETED
5318486,1,1,1704295725,1704295726,1704295774,48,COMPLETED
5318487,1,1,1704295725,1704295726,1704295783,57,COMPLETED
5318488,1,1,1704295725,1704295726,1704295783,57,COMPLETED
5318489,1,1,1704295725,1704295726,1704295775,49,COMPLETED
5318490,1,1,1704295725,1704295726,1704295772,46,COMPLETED
5318491,1,1,1704295725,1704295726,1704295772,46,COMPLETED
5318492,1,1,1704295725,1704295726,1704295774,48,COMPLETED
5318493,1,1,1704295725,1704295726,1704295774,48,COMPLETED
5318494,1,1,1704295725,1704295726,1704295772,46,COMPLETED
5318495,1,1,1704295725,1704295726,1704295777,51,COMPLETED
5318496,1,1,1704295725,1704295726,1704295772,46,COMPLETED
5318497,1,1,1704295726,1704295726,1704295775,49,COMPLETED
5318498,1,1,1704295726,1704295726,1704295773,47,COMPLETED
5318499,1,1,1704295726,1704295726,1704295772,46,COMPLETED
5318500,1,1,1704295726,1704295726,1704295773,47,COMPLETED
5318501,1,1,1704295726,1704295726,1704295777,51,COMPLETED
5318502,1,1,1704295726,1704295726,1704295773,47,COMPLETED
5318503,1,1,1704295726,1704295727,1704295771,44,COMPLETED
5318504,1,1,1704295726,1704295727,1704295773,46,COMPLETED
5318505,1,1,1704295726,1704295727,1704295771,44,COMPLETED
5318506,1,1,1704295726,1704295727,1704295775,48,COMPLETED
5318507,1,1,1704295727,1704295727,1704295777,50,COMPLETED
5318508,1,1,1704295727,1704295727,1704295773,46,COMPLETED
5318509,1,1,1704295727,1704295727,1704295773,46,COMPLETED
5318510,1,1,1704295727,1704295727,1704295775,48,COMPLETED
5318511,1,1,1704295727,1704295727,1704295772,45,COMPLETED
5318512,1,1,1704295727,1704295727,1704295771,44,COMPLETED
5318513,1,1,1704295727,1704295728,1704295777,49,COMPLETED
5318514,1,1,1704295727,1704295728,1704295774,46,COMPLETED
5318515,1,1,1704295727,1704295728,1704295773,45,COMPLETED
5318516,1,1,1704295727,1704295728,1704295777,49,COMPLETED
5318517,1,1,1704295728,1704295728,1704295771,43,COMPLETED
5318518,1,1,1704295728,1704295728,1704295774,46,COMPLETED
5318519,1,1,1704295728,1704295728,1704295772,44,COMPLETED
5318520,1,1,1704295728,1704295728,1704295772,44,COMPLETED
5318521,1,1,1704295728,1704295728,1704295773,45,COMPLETED
5318522,1,1,1704295728,1704295728,1704295773,45,COMPLETED
5318523,1,1,1704295728,1704295728,1704295774,46,COMPLETED
5318524,1,1,1704295728,1704295728,1704295772,44,COMPLETED
5318525,1,1,1704295728,1704295729,1704295771,42,COMPLETED
5318526,1,1,1704295728,1704295729,1704295774,45,COMPLETED
5318527,1,1,1704295728,1704295729,1704295773,44,COMPLETED
5318528,1,1,1704295729,1704295729,1704295770,41,COMPLETED
5318529,1,1,1704295729,1704295729,1704295770,41,COMPLETED
5318530,1,1,1704295729,1704295729,1704295770,41,COMPLETED
5318531,1,1,1704295729,1704295729,1704295773,44,COMPLETED
5318532,1,1,1704295729,1704295729,1704295778,49,COMPLETED
5318533,1,1,1704295729,1704295729,1704295770,41,COMPLETED
5318534,1,1,1704295729,1704295729,1704295770,41,COMPLETED
5318535,1,1,1704295729,1704295730,1704295777,47,COMPLETED
5318536,1,1,1704295730,1704295730,1704295771,41,COMPLETED
5318537,1,1,1704295730,1704295730,1704295770,40,COMPLETED
5318538,1,1,1704295730,1704295730,1704295770,40,COMPLETED
5318539,1,1,1704295730,1704295730,1704295772,42,COMPLETED
5318540,1,1,1704295730,1704295730,1704295776,46,COMPLETED
5318541,1,1,1704295730,1704295730,1704295770,40,COMPLETED
5318542,1,1,1704295730,1704295730,1704295770,40,COMPLETED
5318543,1,1,1704295730,1704295732,1704295770,38,COMPLETED
5318544,1,1,1704295730,1704295732,1704295770,38,COMPLETED
5318545,1,1,1704295730,1704295732,1704295770,38,COMPLETED
5318546,1,1,1704295730,1704295732,1704295770,38,COMPLETED
5318547,1,1,1704295730,1704295732,1704295770,38,COMPLETED
5318548,1,1,1704295731,1704295732,1704295770,38,COMPLETED
5318549,1,1,1704295731,1704295732,1704295770,38,COMPLETED
5318550,1,1,1704295731,1704295732,1704295773,41,COMPLETED
5318551,1,1,1704295731,1704295732,1704295771,39,COMPLETED
5318552,1,1,1704295731,1704295732,1704295770,38,COMPLETED
5318553,1,1,1704295731,1704295732,1704295774,42,COMPLETED
5318554,1,1,1704295731,1704295732,1704295774,42,COMPLETED
5318555,1,1,1704295731,1704295732,1704295777,45,COMPLETED
5318556,1,1,1704295731,1704295732,1704295774,42,COMPLETED
5318557,1,1,1704295731,1704295732,1704295771,39,COMPLETED
5318558,1,1,1704295732,1704295732,1704295777,45,COMPLETED
5318559,1,1,1704295732,1704295732,1704295771,39,COMPLETED
5318560,1,1,1704295732,1704295732,1704295775,43,COMPLETED
5318561,1,1,1704295732,1704295732,1704295772,40,COMPLETED
5318562,1,1,1704295732,1704295732,1704295774,42,COMPLETED
5318563,1,1,1704295732,1704295732,1704295770,38,COMPLETED
5318564,1,1,1704295732,1704295733,1704295770,37,COMPLETED
5318565,1,1,1704295733,1704295733,1704295770,37,COMPLETED
5318566,1,1,1704295733,1704295733,1704295775,42,COMPLETED
5318567,1,1,1704295733,1704295733,1704295770,37,COMPLETED
5318568,1,1,1704295733,1704295733,1704295770,37,COMPLETED
5318569,1,1,1704295733,1704295733,1704295771,38,COMPLETED
5318570,1,1,1704295733,1704295733,1704295774,41,COMPLETED
5318571,1,1,1704295733,1704295733,1704295770,37,COMPLETED
5318572,1,1,1704295733,1704295734,1704295771,37,COMPLETED
5318573,1,1,1704295733,1704295734,1704295770,36,COMPLETED
5318574,1,1,1704295734,1704295734,1704295771,37,COMPLETED
5318575,1,1,1704295734,1704295734,1704295774,40,COMPLETED
5318576,1,1,1704295734,1704295734,1704295770,36,COMPLETED
5318577,1,1,1704295734,1704295734,1704295772,38,COMPLETED
5318578,1,1,1704295734,1704295734,1704295770,36,COMPLETED
5318579,1,1,1704295734,1704295734,1704295770,36,COMPLETED
5318580,1,1,1704295734,1704295734,1704295770,36,COMPLETED
5318581,1,1,1704295734,1704295734,1704295771,37,COMPLETED
5318582,1,1,1704295734,1704295734,1704295770,36,COMPLETED
5318583,1,1,1704295736,1704295737,1704295804,67,COMPLETED
5318584,1,1,1704295764,1704295766,1704295805,39,COMPLETED
5318585,1,1,1704295764,1704295766,1704295805,39,COMPLETED
5318586,1,1,1704295764,1704295766,1704295803,37,COMPLETED
5318587,1,1,1704295764,1704295766,1704295806,40,COMPLETED
5318588,1,1,1704295764,1704295766,1704295801,35,COMPLETED
5318589,1,1,1704295764,1704295766,1704295803,37,COMPLETED
5318590,1,1,1704295764,1704295766,1704295803,37,COMPLETED
5318591,1,1,1704295764,1704295766,1704295803,37,COMPLETED
5318592,1,1,1704295764,1704295766,1704295805,39,COMPLETED
5318593,1,1,1704295765,1704295766,1704295801,35,COMPLETED
5318594,1,1,1704295765,1704295766,1704295801,35,COMPLETED
5318595,1,1,1704295765,1704295766,1704295801,35,COMPLETED
5318596,1,1,1704295765,1704295766,1704295801,35,COMPLETED
5318597,1,1,1704295765,1704295766,1704295801,35,COMPLETED
5318598,1,1,1704295765,1704295766,1704295804,38,COMPLETED
5318599,1,1,1704295765,1704295766,1704295798,32,COMPLETED
5318600,1,1,1704295765,1704295766,1704295796,30,COMPLETED
5318601,1,1,1704295765,1704295766,1704295798,32,COMPLETED
5318602,1,1,1704295765,1704295766,1704295797,31,COMPLETED
5318603,1,1,1704295766,1704295766,1704295798,32,COMPLETED
5318604,1,1,1704295766,1704295766,1704295798,32,COMPLETED
5318605,1,1,1704295766,1704295766,1704295797,31,COMPLETED
5318606,1,1,1704295766,1704295770,1704295796,26,COMPLETED
5318607,1,1,1704295766,1704295770,1704295795,25,COMPLETED
5318608,1,1,1704295766,1704295770,1704295794,24,COMPLETED
5318609,1,1,1704295767,1704295770,1704295795,25,COMPLETED
5318610,1,1,1704295767,1704295770,1704295795,25,COMPLETED
5318611,1,1,1704295767,1704295770,1704295794,24,COMPLETED
5318612,1,1,1704295767,1704295770,1704295795,25,COMPLETED
5318613,1,1,1704295777,1704295777,1704295805,28,COMPLETED
5318614,1,1,1704295778,1704295778,1704295804,26,COMPLETED
5318615,1,1,1704295778,1704295778,1704295804,26,COMPLETED
5318616,1,1,1704295778,1704295778,1704295806,28,COMPLETED
5318617,1,1,1704295778,1704295778,1704295804,26,COMPLETED
5318618,1,1,1704295778,1704295778,1704295804,26,COMPLETED
5318619,1,1,1704295778,1704295778,1704295804,26,COMPLETED
5318620,1,1,1704295778,1704295778,1704295805,27,COMPLETED
5318621,1,1,1704295778,1704295778,1704295805,27,COMPLETED
5318622,1,1,1704295778,1704295778,1704295804,26,COMPLETED
5318623,1,1,1704295778,1704295778,1704295805,27,COMPLETED
5318624,1,1,1704295779,1704295779,1704295814,35,COMPLETED
5318625,1,1,1704295779,1704295780,1704295800,20,COMPLETED
5318626,1,1,1704295779,1704295780,1704295798,18,COMPLETED
5318627,1,1,1704295779,1704295780,1704295802,22,COMPLETED
5318628,1,1,1704295779,1704295780,1704295815,35,COMPLETED
5318629,1,1,1704295779,1704295780,1704295800,20,COMPLETED
5318630,1,1,1704295779,1704295780,1704295801,21,COMPLETED
5318631,1,1,1704295779,1704295780,1704295799,19,COMPLETED
5318632,1,1,1704295779,1704295780,1704295802,22,COMPLETED
5318633,1,1,1704295779,1704295780,1704295801,21,COMPLETED
5318634,1,1,1704295780,1704295781,1704295818,37,COMPLETED
5318635,1,1,1704295780,1704295781,1704295817,36,COMPLETED
5318636,1,1,1704295780,1704295781,1704295815,34,COMPLETED
5318637,1,1,1704295780,1704295781,1704295816,35,COMPLETED
5318638,1,1,1704295780,1704295781,1704295816,35,COMPLETED
5318639,1,1,1704295780,1704295781,1704295816,35,COMPLETED
5318640,1,1,1704295780,1704295781,1704295816,35,COMPLETED
5318641,1,1,1704295780,1704295781,1704295816,35,COMPLETED
5318642,1,1,1704295780,1704295781,1704295819,38,COMPLETED
5318643,1,1,1704295780,1704295781,1704295817,36,COMPLETED
5318644,1,1,1704295781,1704295781,1704295818,37,COMPLETED
5318645,1,1,1704295781,1704295781,1704295819,38,COMPLETED
5318646,1,1,1704295781,1704295781,1704295818,37,COMPLETED
5318647,1,1,1704295781,1704295781,1704295818,37,COMPLETED
5318648,1,1,1704295781,1704295781,1704295816,35,COMPLETED
5318649,1,1,1704295781,1704295781,1704295816,35,COMPLETED
5318650,1,1,1704295781,1704295781,1704295816,35,COMPLETED
5318651,1,1,1704295781,1704295781,1704295816,35,COMPLETED
5318652,1,1,1704295781,1704295781,1704295819,38,COMPLETED
5318653,1,1,1704295781,1704295781,1704295813,32,COMPLETED
5318654,1,1,1704295782,1704295784,1704295818,34,COMPLETED
5318655,1,1,1704295782,1704295784,1704295814,30,COMPLETED
5318656,1,1,1704295783,1704295784,1704295814,30,COMPLETED
5318657,1,1,1704295783,1704295784,1704295815,31,COMPLETED
5318658,1,1,1704295783,1704295784,1704295814,30,COMPLETED
5318659,1,1,1704295783,1704295784,1704295814,30,COMPLETED
5318660,1,1,1704295783,1704295784,1704295814,30,COMPLETED
5318661,1,1,1704295783,1704295784,1704295815,31,COMPLETED
5318662,1,1,1704295783,1704295784,1704295815,31,COMPLETED
5318663,1,1,1704295783,1704295784,1704295815,31,COMPLETED
5318664,1,1,1704295783,1704295784,1704295815,31,COMPLETED
5318665,1,1,1704295783,1704295784,1704295814,30,COMPLETED
5318666,1,1,1704295783,1704295784,1704295815,31,COMPLETED
5318667,1,1,1704295783,1704295784,1704295814,30,COMPLETED
5318668,1,1,1704295783,1704295784,1704295815,31,COMPLETED
5318669,1,1,1704295784,1704295784,1704295814,30,COMPLETED
5318670,1,1,1704295784,1704295786,1704295813,27,COMPLETED
5318671,1,1,1704295784,1704295786,1704295813,27,COMPLETED
5318672,1,1,1704295784,1704295786,1704295813,27,COMPLETED
5318673,1,1,1704295784,1704295786,1704295813,27,COMPLETED
5318674,1,1,1704295784,1704295786,1704295813,27,COMPLETED
5318675,1,1,1704295784,1704295786,1704295813,27,COMPLETED
5318676,1,1,1704295784,1704295786,1704295813,27,COMPLETED
5318677,1,1,1704295784,1704295786,1704295813,27,COMPLETED
5318678,1,1,1704295874,1704295874,1704295928,54,COMPLETED
5318679,1,1,1704295874,1704295874,1704295928,54,COMPLETED
5318680,1,1,1704295874,1704295874,1704295928,54,COMPLETED
5318681,1,1,1704295874,1704295874,1704295928,54,COMPLETED
5318682,1,1,1704295874,1704295874,1704295930,56,COMPLETED
5318683,1,1,1704295874,1704295874,1704295928,54,COMPLETED
5318684,1,1,1704295874,1704295874,1704295928,54,COMPLETED
5318685,1,1,1704295874,1704295874,1704295929,55,COMPLETED
5318686,1,1,1704295874,1704295874,1704295928,54,COMPLETED
5318687,1,1,1704295874,1704295874,1704295937,63,COMPLETED
5318688,1,1,1704295874,1704295874,1704295928,54,COMPLETED
5318689,1,1,1704295874,1704295874,1704295928,54,COMPLETED
5318690,1,1,1704295874,1704295874,1704295928,54,COMPLETED
5318691,1,1,1704295874,1704295874,1704295928,54,COMPLETED
5318692,1,1,1704295874,1704295874,1704295928,54,COMPLETED
5318693,1,1,1704295874,1704295874,1704295928,54,COMPLETED
5318694,1,1,1704295874,1704295874,1704295928,54,COMPLETED
5318696,1,1,1704295874,1704295874,1704295929,55,COMPLETED
5318697,1,1,1704295874,1704295874,1704295930,56,COMPLETED
5318698,1,1,1704295874,1704295874,1704295933,59,COMPLETED
5318699,1,1,1704295874,1704295874,1704295928,54,COMPLETED
5318700,1,1,1704295874,1704295874,1704295928,54,COMPLETED
5318701,1,1,1704295874,1704295874,1704295930,56,COMPLETED
5318702,1,1,1704295874,1704295874,1704295928,54,COMPLETED
5318703,1,1,1704295874,1704295874,1704295928,54,COMPLETED
5318704,1,1,1704295874,1704295874,1704295928,54,COMPLETED
5318705,1,1,1704295874,1704295874,1704295928,54,COMPLETED
5318706,1,1,1704295874,1704295874,1704295928,54,COMPLETED
5318707,1,1,1704295874,1704295879,1704295929,50,COMPLETED
5318708,1,1,1704295874,1704295879,1704295929,50,COMPLETED
5318695,1,1,1704295874,1704295874,1704296147,273,COMPLETED
5318709,1,1,1704295875,1704295879,1704295935,56,COMPLETED
5318710,1,1,1704295875,1704295879,1704295929,50,COMPLETED
5318711,1,1,1704295875,1704295879,1704295928,49,COMPLETED
5318712,1,1,1704295875,1704295879,1704295934,55,COMPLETED
5318713,1,1,1704295875,1704295879,1704295928,49,COMPLETED
5318714,1,1,1704295875,1704295879,1704295928,49,COMPLETED
5318715,1,1,1704295875,1704295879,1704295928,49,COMPLETED
5318716,1,1,1704295875,1704295879,1704295929,50,COMPLETED
5318717,1,1,1704295875,1704295879,1704295928,49,COMPLETED
5318718,1,1,1704295875,1704295879,1704295928,49,COMPLETED
5318719,1,1,1704295875,1704295879,1704295938,59,COMPLETED
5318720,1,1,1704295875,1704295879,1704295929,50,COMPLETED
5318721,1,1,1704295875,1704295879,1704295931,52,COMPLETED
5318722,1,1,1704295875,1704295879,1704295929,50,COMPLETED
5318723,1,1,1704295875,1704295879,1704295929,50,COMPLETED
5318724,1,1,1704295875,1704295879,1704295929,50,COMPLETED
5318725,1,1,1704295875,1704295879,1704295928,49,COMPLETED
5318726,1,1,1704295875,1704295879,1704295928,49,COMPLETED
5318727,1,1,1704295875,1704295879,1704295930,51,COMPLETED
5318728,1,1,1704295875,1704295879,1704295936,57,COMPLETED
5318729,1,1,1704295875,1704295879,1704295928,49,COMPLETED
5318730,1,1,1704295875,1704295879,1704295929,50,COMPLETED
5318731,1,1,1704295875,1704295879,1704295928,49,COMPLETED
5318732,1,1,1704295875,1704295879,1704295928,49,COMPLETED
5318733,1,1,1704295875,1704295879,1704295928,49,COMPLETED
5318734,1,1,1704295875,1704295879,1704295931,52,COMPLETED
5318735,1,1,1704295875,1704295879,1704295931,52,COMPLETED
5318736,1,1,1704295875,1704295879,1704295929,50,COMPLETED
5318737,1,1,1704295875,1704295879,1704295928,49,COMPLETED
5318738,1,1,1704295875,1704295879,1704295929,50,COMPLETED
5318739,1,1,1704295875,1704295879,1704295928,49,COMPLETED
5318740,1,1,1704295875,1704295879,1704295929,50,COMPLETED
5318741,1,1,1704295876,1704295879,1704295928,49,COMPLETED
5318742,1,1,1704295876,1704295879,1704295930,51,COMPLETED
5318743,1,1,1704295876,1704295879,1704295928,49,COMPLETED
5318744,1,1,1704295876,1704295879,1704295929,50,COMPLETED
5318745,1,1,1704295876,1704295879,1704295928,49,COMPLETED
5318746,1,1,1704295876,1704295879,1704295930,51,COMPLETED
5318747,1,1,1704295876,1704295879,1704295929,50,COMPLETED
5318748,1,1,1704295876,1704295879,1704295928,49,COMPLETED
5318749,1,1,1704295876,1704295879,1704295929,50,COMPLETED
5318750,1,1,1704295876,1704295879,1704295928,49,COMPLETED
5318751,1,1,1704295876,1704295879,1704295928,49,COMPLETED
5318752,1,1,1704295876,1704295879,1704295928,49,COMPLETED
5318753,1,1,1704295876,1704295879,1704295928,49,COMPLETED
5318754,1,1,1704295876,1704295879,1704295934,55,COMPLETED
5318755,1,1,1704295876,1704295879,1704295928,49,COMPLETED
5318756,1,1,1704295876,1704295879,1704295930,51,COMPLETED
5318757,1,1,1704295876,1704295879,1704295928,49,COMPLETED
5318758,1,1,1704295876,1704295879,1704295928,49,COMPLETED
5318759,1,1,1704295876,1704295879,1704295928,49,COMPLETED
5318760,1,1,1704295876,1704295879,1704295930,51,COMPLETED
5318761,1,1,1704295876,1704295879,1704295928,49,COMPLETED
5318762,1,1,1704295876,1704295879,1704295930,51,COMPLETED
5318763,1,1,1704295876,1704295879,1704295928,49,COMPLETED
5318764,1,1,1704295876,1704295879,1704295928,49,COMPLETED
5318765,1,1,1704295876,1704295879,1704295934,55,COMPLETED
5318766,1,1,1704295876,1704295879,1704295929,50,COMPLETED
5318767,1,1,1704295876,1704295879,1704295930,51,COMPLETED
5318768,1,1,1704295876,1704295879,1704295933,54,COMPLETED
5318769,1,1,1704295876,1704295879,1704295928,49,COMPLETED
5318770,1,1,1704295876,1704295879,1704295930,51,COMPLETED
5318771,1,1,1704295876,1704295879,1704295928,49,COMPLETED
5318772,1,1,1704295876,1704295879,1704295928,49,COMPLETED
5318773,1,1,1704295876,1704295879,1704295929,50,COMPLETED
5318774,1,1,1704295876,1704295879,1704295928,49,COMPLETED
5318775,1,1,1704295876,1704295879,1704295928,49,COMPLETED
5318776,1,1,1704295876,1704295879,1704295928,49,COMPLETED
5318777,1,1,1704295876,1704295879,1704295928,49,COMPLETED
5318778,1,1,1704295876,1704295879,1704295928,49,COMPLETED
5318779,1,1,1704295876,1704295879,1704295928,49,COMPLETED
5318780,1,1,1704295877,1704295879,1704295928,49,COMPLETED
5318781,1,1,1704295877,1704295879,1704295928,49,COMPLETED
5318782,1,1,1704295877,1704295879,1704295929,50,COMPLETED
5318783,1,1,1704295877,1704295879,1704295928,49,COMPLETED
5318784,1,1,1704295877,1704295879,1704295928,49,COMPLETED
5318785,1,1,1704295877,1704295879,1704295929,50,COMPLETED
5318786,1,1,1704295877,1704295879,1704295928,49,COMPLETED
5318787,1,1,1704295877,1704295879,1704295928,49,COMPLETED
5318788,1,1,1704295877,1704295879,1704295934,55,COMPLETED
5318789,1,1,1704295877,1704295879,1704295928,49,COMPLETED
5318790,1,1,1704295877,1704295879,1704295928,49,COMPLETED
5318791,1,1,1704295877,1704295879,1704295931,52,COMPLETED
5318792,1,1,1704295877,1704295879,1704295928,49,COMPLETED
5318793,1,1,1704295877,1704295879,1704295928,49,COMPLETED
5318794,1,1,1704295877,1704295879,1704295938,59,COMPLETED
5318795,1,1,1704295877,1704295879,1704295928,49,COMPLETED
5318796,1,1,1704295877,1704295879,1704295928,49,COMPLETED
5318797,1,1,1704295877,1704295879,1704295937,58,COMPLETED
5318798,1,1,1704295877,1704295879,1704295928,49,COMPLETED
5318799,1,1,1704295877,1704295879,1704295929,50,COMPLETED
5318800,1,1,1704295877,1704295879,1704295931,52,COMPLETED
5318801,1,1,1704295877,1704295879,1704295929,50,COMPLETED
5318802,1,1,1704295877,1704295879,1704295934,55,COMPLETED
5318803,1,1,1704295877,1704295879,1704295928,49,COMPLETED
5318804,1,1,1704295877,1704295879,1704295928,49,COMPLETED
5318805,1,1,1704295877,1704295879,1704295928,49,COMPLETED
5318806,1,1,1704295877,1704295879,1704295928,49,COMPLETED
5318807,1,1,1704295877,1704295879,1704295929,50,COMPLETED
5318808,1,1,1704295877,1704295879,1704295935,56,COMPLETED
5318809,1,1,1704295877,1704295879,1704295928,49,COMPLETED
5318810,1,1,1704295877,1704295879,1704295929,50,COMPLETED
5318811,1,1,1704295877,1704295879,1704295931,52,COMPLETED
5318812,1,1,1704295877,1704295879,1704295928,49,COMPLETED
5318813,1,1,1704295877,1704295879,1704295928,49,COMPLETED
5318814,1,1,1704295877,1704295879,1704295930,51,COMPLETED
5318815,1,1,1704295877,1704295879,1704295929,50,COMPLETED
5318816,1,1,1704295877,1704295879,1704295935,56,COMPLETED
5318817,1,1,1704295877,1704295879,1704295933,54,COMPLETED
5318818,1,1,1704295877,1704295879,1704295928,49,COMPLETED
5318819,1,1,1704295877,1704295879,1704295928,49,COMPLETED
5318820,1,1,1704295877,1704295879,1704295928,49,COMPLETED
5318821,1,1,1704295877,1704295879,1704295928,49,COMPLETED
5318822,1,1,1704295877,1704295879,1704295928,49,COMPLETED
5318823,1,1,1704295877,1704295879,1704295928,49,COMPLETED
5318824,1,1,1704295877,1704295879,1704295928,49,COMPLETED
5318825,1,1,1704295877,1704295879,1704295928,49,COMPLETED
5318826,1,1,1704295877,1704295879,1704295928,49,COMPLETED
5318827,1,1,1704295877,1704295879,1704295928,49,COMPLETED
5318828,1,1,1704295877,1704295879,1704295930,51,COMPLETED
5318829,1,1,1704295877,1704295879,1704295929,50,COMPLETED
5318830,1,1,1704295877,1704295879,1704295928,49,COMPLETED
5318831,1,1,1704295877,1704295879,1704295930,51,COMPLETED
5318832,1,1,1704295877,1704295879,1704295928,49,COMPLETED
5318833,1,1,1704295877,1704295879,1704295930,51,COMPLETED
5318834,1,1,1704295877,1704295879,1704295931,52,COMPLETED
5318835,1,1,1704295877,1704295879,1704295933,54,COMPLETED
5318836,1,1,1704295877,1704295879,1704295928,49,COMPLETED
5318837,1,1,1704295878,1704295879,1704295928,49,COMPLETED
5318838,1,1,1704295878,1704295879,1704295931,52,COMPLETED
5318839,1,1,1704295878,1704295879,1704295928,49,COMPLETED
5318840,1,1,1704295878,1704295879,1704295930,51,COMPLETED
5318841,1,1,1704295878,1704295879,1704295931,52,COMPLETED
5318842,1,1,1704295878,1704295879,1704295929,50,COMPLETED
5318843,1,1,1704295878,1704295879,1704295932,53,COMPLETED
5318844,1,1,1704295878,1704295879,1704295930,51,COMPLETED
5318845,1,1,1704295878,1704295879,1704295928,49,COMPLETED
5318846,1,1,1704295878,1704295879,1704295932,53,COMPLETED
5318847,1,1,1704295878,1704295879,1704295929,50,COMPLETED
5318848,1,1,1704295878,1704295879,1704295928,49,COMPLETED
5318849,1,1,1704295878,1704295879,1704295937,58,COMPLETED
5318850,1,1,1704295878,1704295879,1704295928,49,COMPLETED
5318851,1,1,1704295878,1704295879,1704295928,49,COMPLETED
5318852,1,1,1704295878,1704295879,1704295930,51,COMPLETED
5318853,1,1,1704295878,1704295879,1704295929,50,COMPLETED
5318854,1,1,1704295878,1704295879,1704295928,49,COMPLETED
5318855,1,1,1704295878,1704295879,1704295928,49,COMPLETED
5318856,1,1,1704295878,1704295879,1704295928,49,COMPLETED
5318857,1,1,1704295878,1704295879,1704295928,49,COMPLETED
5318858,1,1,1704295878,1704295879,1704295928,49,COMPLETED
5318859,1,1,1704295878,1704295879,1704295928,49,COMPLETED
5318860,1,1,1704295878,1704295879,1704295928,49,COMPLETED
5318861,1,1,1704295878,1704295879,1704295928,49,COMPLETED
5318862,1,1,1704295878,1704295879,1704295928,49,COMPLETED
5318863,1,1,1704295879,1704295879,1704295928,49,COMPLETED
5318864,1,1,1704295879,1704295882,1704295928,46,COMPLETED
5318865,1,1,1704295879,1704295882,1704295928,46,COMPLETED
5318866,1,1,1704295879,1704295882,1704295928,46,COMPLETED
5318867,1,1,1704295879,1704295882,1704295928,46,COMPLETED
5318868,1,1,1704295880,1704295882,1704295928,46,COMPLETED
5318869,1,1,1704295880,1704295882,1704295928,46,COMPLETED
5318870,1,1,1704295880,1704295882,1704295928,46,COMPLETED
5318871,1,1,1704295880,1704295882,1704295933,51,COMPLETED
5318872,1,1,1704295880,1704295882,1704295928,46,COMPLETED
5318873,1,1,1704295880,1704295882,1704295928,46,COMPLETED
5318874,1,1,1704295880,1704295882,1704295928,46,COMPLETED
5318875,1,1,1704295880,1704295882,1704295928,46,COMPLETED
5318876,1,1,1704295880,1704295882,1704295928,46,COMPLETED
5318877,1,1,1704295880,1704295882,1704295928,46,COMPLETED
5318878,1,1,1704295929,1704295929,1704295961,32,COMPLETED
5318879,1,1,1704295929,1704295929,1704295961,32,COMPLETED
5318880,1,1,1704295929,1704295929,1704295961,32,COMPLETED
5318881,1,1,1704295929,1704295929,1704295961,32,COMPLETED
5318882,1,1,1704295929,1704295930,1704295961,31,COMPLETED
5318883,1,1,1704295929,1704295930,1704295961,31,COMPLETED
5318884,1,1,1704295929,1704295930,1704295961,31,COMPLETED
5318885,1,1,1704295929,1704295930,1704295961,31,COMPLETED
5318886,1,1,1704295930,1704295930,1704295961,31,COMPLETED
5318887,1,1,1704295939,1704295939,1704295968,29,COMPLETED
5318888,1,1,1704295939,1704295939,1704295970,31,COMPLETED
5318889,1,1,1704295939,1704295939,1704295970,31,COMPLETED
5318890,1,1,1704295939,1704295939,1704295968,29,COMPLETED
5318891,1,1,1704295939,1704295939,1704295970,31,COMPLETED
5318892,1,1,1704295939,1704295939,1704295970,31,COMPLETED
5318893,1,1,1704295939,1704295939,1704295971,32,COMPLETED
5318894,1,1,1704295939,1704295940,1704295969,29,COMPLETED
5318895,1,1,1704295939,1704295940,1704295970,30,COMPLETED
5318896,1,1,1704295939,1704295940,1704295970,30,COMPLETED
5318897,1,1,1704295940,1704295942,1704295969,27,COMPLETED
5318898,1,1,1704295940,1704295942,1704295969,27,COMPLETED
5318899,1,1,1704295940,1704295942,1704295968,26,COMPLETED
5318900,1,1,1704295940,1704295942,1704295970,28,COMPLETED
5318901,1,1,1704295940,1704295942,1704295971,29,COMPLETED
5318902,1,1,1704295940,1704295942,1704295970,28,COMPLETED
5318903,1,1,1704295940,1704295942,1704295970,28,COMPLETED
5318904,1,1,1704295940,1704295942,1704295968,26,COMPLETED
5318905,1,1,1704295940,1704295942,1704295970,28,COMPLETED
5318906,1,1,1704295941,1704295942,1704295970,28,COMPLETED
5318907,1,1,1704295941,1704295942,1704295969,27,COMPLETED
5318908,1,1,1704295941,1704295942,1704295972,30,COMPLETED
5318909,1,1,1704295941,1704295942,1704295968,26,COMPLETED
5318910,1,1,1704295941,1704295942,1704295970,28,COMPLETED
5318911,1,1,1704295941,1704295942,1704295968,26,COMPLETED
5318912,1,1,1704295941,1704295942,1704295968,26,COMPLETED
5318913,1,1,1704295941,1704295942,1704295970,28,COMPLETED
5318914,1,1,1704295941,1704295942,1704295970,28,COMPLETED
5318915,1,1,1704295941,1704295942,1704295976,34,COMPLETED
5318916,1,1,1704295942,1704295943,1704295971,28,COMPLETED
5318917,1,1,1704295942,1704295943,1704295971,28,COMPLETED
5318918,1,1,1704295942,1704295943,1704295971,28,COMPLETED
5318919,1,1,1704295942,1704295943,1704295971,28,COMPLETED
5318920,1,1,1704295942,1704295943,1704295971,28,COMPLETED
5318921,1,1,1704295942,1704295943,1704295972,29,COMPLETED
5318922,1,1,1704295942,1704295943,1704295971,28,COMPLETED
5318923,1,1,1704295942,1704295943,1704295969,26,COMPLETED
5318924,1,1,1704295942,1704295943,1704295969,26,COMPLETED
5318925,1,1,1704295942,1704295943,1704295967,24,COMPLETED
5318926,1,1,1704295943,1704295943,1704295968,25,COMPLETED
5318927,1,1,1704295943,1704295943,1704295969,26,COMPLETED
5318928,1,1,1704295943,1704295943,1704295969,26,COMPLETED
5318929,1,1,1704295943,1704295943,1704295969,26,COMPLETED
5318930,1,1,1704295943,1704295943,1704295976,33,COMPLETED
5318931,1,1,1704295943,1704295946,1704295985,39,COMPLETED
5318932,1,1,1704295943,1704295946,1704295984,38,COMPLETED
5318933,1,1,1704295943,1704295946,1704295984,38,COMPLETED
5318934,1,1,1704295943,1704295946,1704295977,31,COMPLETED
5318935,1,1,1704295943,1704295946,1704295976,30,COMPLETED
5318936,1,1,1704295944,1704295946,1704295990,44,COMPLETED
5318937,1,1,1704295944,1704295946,1704295977,31,COMPLETED
5318938,1,1,1704295944,1704295946,1704295976,30,COMPLETED
5318939,1,1,1704295944,1704295946,1704295984,38,COMPLETED
5318940,1,1,1704295944,1704295946,1704295984,38,COMPLETED
5318941,1,1,1704295944,1704295946,1704295978,32,COMPLETED
5318942,1,1,1704295944,1704295946,1704295976,30,COMPLETED
5318943,1,1,1704295944,1704295946,1704295984,38,COMPLETED
5318944,1,1,1704295944,1704295946,1704295984,38,COMPLETED
5318945,1,1,1704295944,1704295946,1704295981,35,COMPLETED
5318946,1,1,1704295945,1704295946,1704295984,38,COMPLETED
5318947,1,1,1704295945,1704295946,1704295976,30,COMPLETED
5318948,1,1,1704295945,1704295946,1704295984,38,COMPLETED
5318949,1,1,1704295945,1704295946,1704295989,43,COMPLETED
5318950,1,1,1704295945,1704295946,1704295984,38,COMPLETED
5318951,1,1,1704295945,1704295946,1704295984,38,COMPLETED
5318952,1,1,1704295945,1704295946,1704295978,32,COMPLETED
5318953,1,1,1704295945,1704295946,1704295985,39,COMPLETED
5318954,1,1,1704295945,1704295946,1704295984,38,COMPLETED
5318955,1,1,1704295945,1704295946,1704295985,39,COMPLETED
5318956,1,1,1704295946,1704295950,1704295996,46,COMPLETED
5318957,1,1,1704295946,1704295950,1704295995,45,COMPLETED
5318958,1,1,1704295946,1704295950,1704295999,49,COMPLETED
5318959,1,1,1704295946,1704295950,1704295999,49,COMPLETED
5318960,1,1,1704295946,1704295950,1704296000,50,COMPLETED
5318961,1,1,1704295946,1704295950,1704296002,52,COMPLETED
5318962,1,1,1704295946,1704295950,1704295998,48,COMPLETED
5318963,1,1,1704295946,1704295950,1704296002,52,COMPLETED
5318964,1,1,1704295947,1704295950,1704296012,62,COMPLETED
5318965,1,1,1704295947,1704295950,1704295999,49,COMPLETED
5318966,1,1,1704295947,1704295950,1704296003,53,COMPLETED
5318967,1,1,1704295947,1704295950,1704296004,54,COMPLETED
5318968,1,1,1704295947,1704295950,1704296004,54,COMPLETED
5318969,1,1,1704295947,1704295950,1704296005,55,COMPLETED
5318970,1,1,1704295947,1704295950,1704296011,61,COMPLETED
5318971,1,1,1704295947,1704295950,1704296001,51,COMPLETED
5318972,1,1,1704295947,1704295950,1704296003,53,COMPLETED
5318973,1,1,1704295947,1704295950,1704296002,52,COMPLETED
5318974,1,1,1704295947,1704295950,1704296007,57,COMPLETED
5318975,1,1,1704295947,1704295950,1704296002,52,COMPLETED
5318976,1,1,1704295948,1704295950,1704296006,56,COMPLETED
5318977,1,1,1704295948,1704295950,1704296006,56,COMPLETED
5318978,1,1,1704295948,1704295950,1704296002,52,COMPLETED
5318979,1,1,1704295948,1704295950,1704295999,49,COMPLETED
5318980,1,1,1704295948,1704295950,1704296004,54,COMPLETED
5318981,1,1,1704295948,1704295950,1704296007,57,COMPLETED
5318982,1,1,1704295948,1704295950,1704296000,50,COMPLETED
5318983,1,1,1704295948,1704295950,1704296000,50,COMPLETED
5318984,1,1,1704295948,1704295950,1704295999,49,COMPLETED
5318985,1,1,1704295949,1704295950,1704296004,54,COMPLETED
5318986,1,1,1704295949,1704295950,1704296001,51,COMPLETED
5318987,1,1,1704295949,1704295950,1704296003,53,COMPLETED
5318988,1,1,1704295949,1704295950,1704295999,49,COMPLETED
5318989,1,1,1704295949,1704295950,1704296013,63,COMPLETED
5318990,1,1,1704295949,1704295950,1704296000,50,COMPLETED
5318991,1,1,1704295949,1704295950,1704296005,55,COMPLETED
5318992,1,1,1704295949,1704295950,1704296006,56,COMPLETED
5318993,1,1,1704295949,1704295950,1704296004,54,COMPLETED
5318994,1,1,1704295949,1704295950,1704296000,50,COMPLETED
5318995,1,1,1704295949,1704295950,1704296005,55,COMPLETED
5318996,1,1,1704295950,1704295954,1704296000,46,COMPLETED
5318997,1,1,1704295950,1704295954,1704296005,51,COMPLETED
5318998,1,1,1704295950,1704295954,1704296003,49,COMPLETED
5318999,1,1,1704295950,1704295954,1704296011,57,COMPLETED
5319000,1,1,1704295950,1704295954,1704296004,50,COMPLETED
5319001,1,1,1704295950,1704295954,1704296004,50,COMPLETED
5319002,1,1,1704295950,1704295954,1704296000,46,COMPLETED
5319003,1,1,1704295951,1704295954,1704296008,54,COMPLETED
5319004,1,1,1704295951,1704295954,1704296010,56,COMPLETED
5319005,1,1,1704295951,1704295954,1704296003,49,COMPLETED
5319006,1,1,1704295951,1704295954,1704296005,51,COMPLETED
5319007,1,1,1704295951,1704295954,1704296000,46,COMPLETED
5319008,1,1,1704295951,1704295954,1704296005,51,COMPLETED
5319009,1,1,1704295951,1704295954,1704296000,46,COMPLETED
5319010,1,1,1704295951,1704295954,1704296010,56,COMPLETED
5319011,1,1,1704295951,1704295954,1704296005,51,COMPLETED
5319012,1,1,1704295951,1704295954,1704296004,50,COMPLETED
5319013,1,1,1704295951,1704295954,1704296001,47,COMPLETED
5319014,1,1,1704295951,1704295954,1704296005,51,COMPLETED
5319015,1,1,1704295951,1704295954,1704296000,46,COMPLETED
5319016,1,1,1704295952,1704295954,1704296002,48,COMPLETED
5319017,1,1,1704295952,1704295954,1704296006,52,COMPLETED
5319018,1,1,1704295952,1704295954,1704296001,47,COMPLETED
5319019,1,1,1704295952,1704295954,1704296005,51,COMPLETED
5319020,1,1,1704295952,1704295954,1704296002,48,COMPLETED
5319021,1,1,1704295952,1704295954,1704296001,47,COMPLETED
5319022,1,1,1704295952,1704295954,1704296002,48,COMPLETED
5319023,1,1,1704295952,1704295954,1704296001,47,COMPLETED
5319024,1,1,1704295952,1704295954,1704296001,47,COMPLETED
5319025,1,1,1704295952,1704295954,1704296013,59,COMPLETED
5319026,1,1,1704295953,1704295954,1704296004,50,COMPLETED
5319027,1,1,1704295953,1704295954,1704296002,48,COMPLETED
5319028,1,1,1704295953,1704295954,1704296003,49,COMPLETED
5319029,1,1,1704295953,1704295954,1704296000,46,COMPLETED
5319030,1,1,1704295953,1704295954,1704296003,49,COMPLETED
5319031,1,1,1704295953,1704295954,1704295998,44,COMPLETED
5319032,1,1,1704295953,1704295954,1704296007,53,COMPLETED
5319033,1,1,1704295953,1704295954,1704296000,46,COMPLETED
5319034,1,1,1704295953,1704295954,1704295998,44,COMPLETED
5319035,1,1,1704295953,1704295954,1704296006,52,COMPLETED
5319036,1,1,1704295954,1704295958,1704296013,55,COMPLETED
5319037,1,1,1704295954,1704295958,1704296004,46,COMPLETED
5319038,1,1,1704295954,1704295958,1704295998,40,COMPLETED
5319039,1,1,1704295954,1704295958,1704296003,45,COMPLETED
5319040,1,1,1704295954,1704295958,1704296007,49,COMPLETED
5319041,1,1,1704295954,1704295958,1704296007,49,COMPLETED
5319042,1,1,1704295954,1704295958,1704296008,50,COMPLETED
5319043,1,1,1704295955,1704295958,1704296008,50,COMPLETED
5319044,1,1,1704295955,1704295958,1704296005,47,COMPLETED
5319045,1,1,1704295955,1704295958,1704296002,44,COMPLETED
5319046,1,1,1704295955,1704295958,1704296006,48,COMPLETED
5319047,1,1,1704295955,1704295958,1704296003,45,COMPLETED
5319048,1,1,1704295955,1704295958,1704295997,39,COMPLETED
5319049,1,1,1704295955,1704295958,1704296007,49,COMPLETED
5319050,1,1,1704295955,1704295958,1704296001,43,COMPLETED
5319051,1,1,1704295955,1704295958,1704296007,49,COMPLETED
5319052,1,1,1704295955,1704295958,1704296012,54,COMPLETED
5319053,1,1,1704295955,1704295958,1704296001,43,COMPLETED
5319054,1,1,1704295955,1704295958,1704296006,48,COMPLETED
5319055,1,1,1704295955,1704295958,1704296006,48,COMPLETED
5319056,1,1,1704295956,1704295958,1704296008,50,COMPLETED
5319057,1,1,1704295956,1704295958,1704295998,40,COMPLETED
5319058,1,1,1704295956,1704295958,1704296005,47,COMPLETED
5319059,1,1,1704295956,1704295958,1704296004,46,COMPLETED
5319060,1,1,1704295956,1704295958,1704296003,45,COMPLETED
5319061,1,1,1704295956,1704295958,1704296006,48,COMPLETED
5319062,1,1,1704295956,1704295958,1704296005,47,COMPLETED
5319063,1,1,1704295956,1704295958,1704296001,43,COMPLETED
5319064,1,1,1704295956,1704295958,1704296008,50,COMPLETED
5319065,1,1,1704295956,1704295958,1704296004,46,COMPLETED
5319066,1,1,1704295957,1704295958,1704295993,35,COMPLETED
5319067,1,1,1704295957,1704295958,1704295993,35,COMPLETED
5319068,1,1,1704295957,1704295958,1704295996,38,COMPLETED
5319069,1,1,1704295957,1704295958,1704295995,37,COMPLETED
5319070,1,1,1704295957,1704295958,1704295993,35,COMPLETED
5319071,1,1,1704295957,1704295958,1704295993,35,COMPLETED
5319072,1,1,1704295957,1704295958,1704295993,35,COMPLETED
5319073,1,1,1704295957,1704295958,1704296008,50,COMPLETED
5319074,1,1,1704295957,1704295958,1704295995,37,COMPLETED
5319075,1,1,1704295957,1704295958,1704295993,35,COMPLETED
5319076,1,1,1704295958,1704295962,1704295993,31,COMPLETED
5319077,1,1,1704295968,1704295969,1704296046,77,COMPLETED
5319078,1,1,1704295968,1704295969,1704296043,74,COMPLETED
5319079,1,1,1704295969,1704295969,1704296043,74,COMPLETED
5319080,1,1,1704295969,1704295970,1704296043,73,COMPLETED
5319081,1,1,1704295970,1704295970,1704296043,73,COMPLETED
5319082,1,1,1704295970,1704295970,1704296041,71,COMPLETED
5319083,1,1,1704295970,1704295971,1704296046,75,COMPLETED
5319084,1,1,1704295970,1704295971,1704296044,73,COMPLETED
5319085,1,1,1704295970,1704295971,1704296043,72,COMPLETED
5319086,1,1,1704295971,1704295971,1704296044,73,COMPLETED
5319087,1,1,1704295971,1704295971,1704296043,72,COMPLETED
5319088,1,1,1704295971,1704295971,1704296047,76,COMPLETED
5319089,1,1,1704295971,1704295972,1704296045,73,COMPLETED
5319090,1,1,1704295971,1704295972,1704296046,74,COMPLETED
5319091,1,1,1704295972,1704295972,1704296046,74,COMPLETED
5319092,1,1,1704295972,1704295972,1704296045,73,COMPLETED
5319093,1,1,1704295972,1704295972,1704296045,73,COMPLETED
5319094,1,1,1704295972,1704295972,1704296045,73,COMPLETED
5319095,1,1,1704295972,1704295972,1704296045,73,COMPLETED
5319096,1,1,1704295972,1704295972,1704296043,71,COMPLETED
5319097,1,1,1704295972,1704295972,1704296043,71,COMPLETED
5319098,1,1,1704295975,1704295977,1704296045,68,COMPLETED
5319099,1,1,1704295975,1704295977,1704296047,70,COMPLETED
5319100,1,1,1704295987,1704295988,1704296041,53,COMPLETED
5319101,1,1,1704295988,1704295988,1704296044,56,COMPLETED
5319102,1,1,1704295988,1704295988,1704296043,55,COMPLETED
5319103,1,1,1704295988,1704295988,1704296049,61,COMPLETED
5319104,1,1,1704295988,1704295988,1704296042,54,COMPLETED
5319105,1,1,1704295988,1704295988,1704296044,56,COMPLETED
5319106,1,1,1704295988,1704295991,1704296046,55,COMPLETED
5319107,1,1,1704295988,1704295991,1704296044,53,COMPLETED
5319108,1,1,1704295988,1704295991,1704296043,52,COMPLETED
5319109,1,1,1704295999,1704296000,1704296046,46,COMPLETED
5319110,1,1,1704296000,1704296000,1704296044,44,COMPLETED
5319111,1,1,1704296000,1704296000,1704296043,43,COMPLETED
5319112,1,1,1704296000,1704296000,1704296043,43,COMPLETED
5319113,1,1,1704296000,1704296000,1704296045,45,COMPLETED
5319114,1,1,1704296000,1704296000,1704296045,45,COMPLETED
5319115,1,1,1704296000,1704296001,1704296046,45,COMPLETED
5319116,1,1,1704296001,1704296001,1704296043,42,COMPLETED
5319117,1,1,1704296001,1704296001,1704296044,43,COMPLETED
5319118,1,1,1704296001,1704296001,1704296046,45,COMPLETED
5319119,1,1,1704296001,1704296001,1704296044,43,COMPLETED
5319120,1,1,1704296001,1704296001,1704296041,40,COMPLETED
5319121,1,1,1704296001,1704296001,1704296045,44,COMPLETED
5319122,1,1,1704296001,1704296001,1704296044,43,COMPLETED
5319123,1,1,1704296001,1704296001,1704296043,42,COMPLETED
5319124,1,1,1704296001,1704296001,1704296045,44,COMPLETED
5319125,1,1,1704296001,1704296001,1704296045,44,COMPLETED
5319126,1,1,1704296002,1704296002,1704296045,43,COMPLETED
5319127,1,1,1704296002,1704296002,1704296046,44,COMPLETED
5319128,1,1,1704296002,1704296002,1704296056,54,COMPLETED
5319129,1,1,1704296002,1704296002,1704296045,43,COMPLETED
5319130,1,1,1704296002,1704296002,1704296042,40,COMPLETED
5319131,1,1,1704296002,1704296002,1704296043,41,COMPLETED
5319132,1,1,1704296002,1704296002,1704296045,43,COMPLETED
5319133,1,1,1704296002,1704296002,1704296044,42,COMPLETED
5319134,1,1,1704296002,1704296002,1704296042,40,COMPLETED
5319135,1,1,1704296002,1704296002,1704296044,42,COMPLETED
5319136,1,1,1704296003,1704296003,1704296046,43,COMPLETED
5319137,1,1,1704296004,1704296004,1704296044,40,COMPLETED
5319138,1,1,1704296004,1704296004,1704296043,39,COMPLETED
5319139,1,1,1704296004,1704296004,1704296043,39,COMPLETED
5319140,1,1,1704296004,1704296004,1704296045,41,COMPLETED
5319141,1,1,1704296004,1704296004,1704296043,39,COMPLETED
5319142,1,1,1704296004,1704296004,1704296045,41,COMPLETED
5319143,1,1,1704296004,1704296004,1704296046,42,COMPLETED
5319144,1,1,1704296004,1704296004,1704296044,40,COMPLETED
5319145,1,1,1704296004,1704296004,1704296046,42,COMPLETED
5319146,1,1,1704296004,1704296004,1704296045,41,COMPLETED
5319147,1,1,1704296004,1704296004,1704296046,42,COMPLETED
5319148,1,1,1704296004,1704296004,1704296043,39,COMPLETED
5319149,1,1,1704296004,1704296004,1704296048,44,COMPLETED
5319150,1,1,1704296004,1704296004,1704296040,36,COMPLETED
5319151,1,1,1704296004,1704296004,1704296043,39,COMPLETED
5319152,1,1,1704296004,1704296004,1704296054,50,COMPLETED
5319153,1,1,1704296005,1704296005,1704296046,41,COMPLETED
5319154,1,1,1704296005,1704296005,1704296046,41,COMPLETED
5319155,1,1,1704296005,1704296005,1704296044,39,COMPLETED
5319156,1,1,1704296005,1704296005,1704296043,38,COMPLETED
5319157,1,1,1704296005,1704296005,1704296041,36,COMPLETED
5319158,1,1,1704296005,1704296005,1704296048,43,COMPLETED
5319159,1,1,1704296005,1704296005,1704296048,43,COMPLETED
5319160,1,1,1704296005,1704296005,1704296044,39,COMPLETED
5319161,1,1,1704296005,1704296005,1704296045,40,COMPLETED
5319162,1,1,1704296005,1704296005,1704296048,43,COMPLETED
5319163,1,1,1704296005,1704296005,1704296041,36,COMPLETED
5319164,1,1,1704296005,1704296005,1704296044,39,COMPLETED
5319165,1,1,1704296005,1704296005,1704296040,35,COMPLETED
5319166,1,1,1704296006,1704296006,1704296043,37,COMPLETED
5319167,1,1,1704296006,1704296006,1704296046,40,COMPLETED
5319168,1,1,1704296006,1704296006,1704296048,42,COMPLETED
5319169,1,1,1704296006,1704296006,1704296043,37,COMPLETED
5319170,1,1,1704296006,1704296006,1704296043,37,COMPLETED
5319171,1,1,1704296006,1704296006,1704296048,42,COMPLETED
5319172,1,1,1704296006,1704296006,1704296043,37,COMPLETED
5319173,1,1,1704296006,1704296007,1704296044,37,COMPLETED
5319174,1,1,1704296007,1704296007,1704296033,26,COMPLETED
5319175,1,1,1704296007,1704296007,1704296032,25,COMPLETED
5319176,1,1,1704296007,1704296007,1704296031,24,COMPLETED
5319177,1,1,1704296007,1704296007,1704296031,24,COMPLETED
5319178,1,1,1704296007,1704296007,1704296033,26,COMPLETED
5319179,1,1,1704296007,1704296007,1704296032,25,COMPLETED
5319180,1,1,1704296007,1704296007,1704296031,24,COMPLETED
5319181,1,1,1704296007,1704296007,1704296031,24,COMPLETED
5319182,1,1,1704296007,1704296008,1704296031,23,COMPLETED
5319183,1,1,1704296008,1704296008,1704296044,36,COMPLETED
5319184,1,1,1704296008,1704296008,1704296043,35,COMPLETED
5319185,1,1,1704296008,1704296008,1704296040,32,COMPLETED
5319186,1,1,1704296008,1704296008,1704296046,38,COMPLETED
5319187,1,1,1704296008,1704296008,1704296043,35,COMPLETED
5319188,1,1,1704296008,1704296008,1704296046,38,COMPLETED
5319189,1,1,1704296008,1704296008,1704296045,37,COMPLETED
5319190,1,1,1704296008,1704296008,1704296040,32,COMPLETED
5319191,1,1,1704296009,1704296009,1704296046,37,COMPLETED
5319192,1,1,1704296009,1704296009,1704296034,25,COMPLETED
5319193,1,1,1704296009,1704296009,1704296033,24,COMPLETED
5319194,1,1,1704296009,1704296009,1704296036,27,COMPLETED
5319195,1,1,1704296009,1704296009,1704296034,25,COMPLETED
5319196,1,1,1704296009,1704296009,1704296034,25,COMPLETED
5319197,1,1,1704296009,1704296009,1704296033,24,COMPLETED
5319198,1,1,1704296009,1704296009,1704296033,24,COMPLETED
5319199,1,1,1704296009,1704296010,1704296041,31,COMPLETED
5319200,1,1,1704296010,1704296010,1704296034,24,COMPLETED
5319201,1,1,1704296010,1704296010,1704296034,24,COMPLETED
5319202,1,1,1704296010,1704296010,1704296034,24,COMPLETED
5319203,1,1,1704296010,1704296010,1704296037,27,COMPLETED
5319204,1,1,1704296010,1704296010,1704296033,23,COMPLETED
5319205,1,1,1704296010,1704296011,1704296071,60,COMPLETED
5319206,1,1,1704296010,1704296011,1704296061,50,COMPLETED
5319207,1,1,1704296010,1704296011,1704296060,49,COMPLETED
5319208,1,1,1704296010,1704296011,1704296060,49,COMPLETED
5319209,1,1,1704296011,1704296011,1704296063,52,COMPLETED
5319210,1,1,1704296011,1704296011,1704296061,50,COMPLETED
5319211,1,1,1704296011,1704296011,1704296059,48,COMPLETED
5319212,1,1,1704296011,1704296011,1704296061,50,COMPLETED
5319213,1,1,1704296011,1704296011,1704296061,50,COMPLETED
5319214,1,1,1704296011,1704296012,1704296059,47,COMPLETED
5319215,1,1,1704296011,1704296012,1704296058,46,COMPLETED
5319216,1,1,1704296011,1704296012,1704296058,46,COMPLETED
5319217,1,1,1704296011,1704296012,1704296059,47,COMPLETED
5319218,1,1,1704296012,1704296012,1704296058,46,COMPLETED
5319219,1,1,1704296012,1704296012,1704296061,49,COMPLETED
5319220,1,1,1704296012,1704296012,1704296058,46,COMPLETED
5319221,1,1,1704296012,1704296012,1704296059,47,COMPLETED
5319222,1,1,1704296012,1704296012,1704296059,47,COMPLETED
5319223,1,1,1704296012,1704296012,1704296059,47,COMPLETED
5319224,1,1,1704296012,1704296012,1704296058,46,COMPLETED
5319225,1,1,1704296012,1704296012,1704296061,49,COMPLETED
5319226,1,1,1704296013,1704296013,1704296054,41,COMPLETED
5319227,1,1,1704296013,1704296013,1704296055,42,COMPLETED
5319228,1,1,1704296013,1704296013,1704296056,43,COMPLETED
5319229,1,1,1704296013,1704296013,1704296055,42,COMPLETED
5319230,1,1,1704296013,1704296013,1704296056,43,COMPLETED
5319231,1,1,1704296013,1704296013,1704296058,45,COMPLETED
5319232,1,1,1704296013,1704296013,1704296055,42,COMPLETED
5319233,1,1,1704296013,1704296013,1704296055,42,COMPLETED
5319234,1,1,1704296013,1704296013,1704296056,43,COMPLETED
5319235,1,1,1704296013,1704296013,1704296056,43,COMPLETED
5319236,1,1,1704296013,1704296014,1704296055,41,COMPLETED
5319237,1,1,1704296014,1704296014,1704296059,45,COMPLETED
5319238,1,1,1704296014,1704296014,1704296058,44,COMPLETED
5319239,1,1,1704296014,1704296014,1704296058,44,COMPLETED
5319240,1,1,1704296014,1704296014,1704296060,46,COMPLETED
5319241,1,1,1704296014,1704296014,1704296061,47,COMPLETED
5319242,1,1,1704296014,1704296014,1704296058,44,COMPLETED
5319243,1,1,1704296014,1704296015,1704296058,43,COMPLETED
5319244,1,1,1704296014,1704296015,1704296060,45,COMPLETED
5319245,1,1,1704296014,1704296015,1704296058,43,COMPLETED
5319246,1,1,1704296015,1704296015,1704296061,46,COMPLETED
5319247,1,1,1704296015,1704296018,1704296068,50,COMPLETED
5319248,1,1,1704296015,1704296018,1704296068,50,COMPLETED
5319249,1,1,1704296015,1704296018,1704296068,50,COMPLETED
5319250,1,1,1704296015,1704296018,1704296069,51,COMPLETED
5319251,1,1,1704296015,1704296018,1704296068,50,COMPLETED
5319252,1,1,1704296015,1704296018,1704296068,50,COMPLETED
5319253,1,1,1704296015,1704296018,1704296070,52,COMPLETED
5319254,1,1,1704296015,1704296018,1704296070,52,COMPLETED
5319255,1,1,1704296015,1704296018,1704296071,53,COMPLETED
5319256,1,1,1704296015,1704296018,1704296074,56,COMPLETED
5319257,1,1,1704296016,1704296018,1704296070,52,COMPLETED
5319258,1,1,1704296016,1704296018,1704296070,52,COMPLETED
5319259,1,1,1704296016,1704296018,1704296074,56,COMPLETED
5319260,1,1,1704296016,1704296018,1704296070,52,COMPLETED
5319261,1,1,1704296016,1704296018,1704296070,52,COMPLETED
5319262,1,1,1704296016,1704296018,1704296070,52,COMPLETED
5319263,1,1,1704296016,1704296018,1704296071,53,COMPLETED
5319264,1,1,1704296016,1704296018,1704296071,53,COMPLETED
5319265,1,1,1704296016,1704296018,1704296070,52,COMPLETED
5319266,1,1,1704296033,1704296033,1704296079,46,COMPLETED
5319267,1,1,1704296033,1704296033,1704296080,47,COMPLETED
5319268,1,1,1704296033,1704296033,1704296080,47,COMPLETED
5319269,1,1,1704296034,1704296034,1704296079,45,COMPLETED
5319270,1,1,1704296034,1704296034,1704296079,45,COMPLETED
5319271,1,1,1704296034,1704296034,1704296081,47,COMPLETED
5319272,1,1,1704296034,1704296034,1704296080,46,COMPLETED
5319273,1,1,1704296035,1704296035,1704296081,46,COMPLETED
5319274,1,1,1704296035,1704296035,1704296081,46,COMPLETED
5319275,1,1,1704296035,1704296035,1704296086,51,COMPLETED
5319276,1,1,1704296035,1704296035,1704296081,46,COMPLETED
5319277,1,1,1704296035,1704296035,1704296081,46,COMPLETED
5319278,1,1,1704296035,1704296035,1704296081,46,COMPLETED
5319279,1,1,1704296036,1704296037,1704296079,42,COMPLETED
5319280,1,1,1704296036,1704296037,1704296079,42,COMPLETED
5319281,1,1,1704296036,1704296037,1704296083,46,COMPLETED
5319282,1,1,1704296036,1704296037,1704296084,47,COMPLETED
5319283,1,1,1704296043,1704296043,1704296082,39,COMPLETED
5319284,1,1,1704296043,1704296043,1704296081,38,COMPLETED
5319285,1,1,1704296044,1704296044,1704296081,37,COMPLETED
5319286,1,1,1704296044,1704296044,1704296082,38,COMPLETED
5319287,1,1,1704296045,1704296045,1704296080,35,COMPLETED
5319288,1,1,1704296045,1704296045,1704296082,37,COMPLETED
5319289,1,1,1704296045,1704296045,1704296080,35,COMPLETED
5319290,1,1,1704296045,1704296045,1704296082,37,COMPLETED
5319291,1,1,1704296045,1704296045,1704296083,38,COMPLETED
5319292,1,1,1704296045,1704296045,1704296082,37,COMPLETED
5319293,1,1,1704296045,1704296045,1704296084,39,COMPLETED
5319294,1,1,1704296045,1704296045,1704296083,38,COMPLETED
5319295,1,1,1704296045,1704296045,1704296082,37,COMPLETED
5319296,1,1,1704296046,1704296046,1704296083,37,COMPLETED
5319297,1,1,1704296046,1704296046,1704296085,39,COMPLETED
5319298,1,1,1704296046,1704296046,1704296083,37,COMPLETED
5319299,1,1,1704296046,1704296046,1704296084,38,COMPLETED
5319300,1,1,1704296046,1704296046,1704296084,38,COMPLETED
5319301,1,1,1704296046,1704296046,1704296082,36,COMPLETED
5319302,1,1,1704296046,1704296047,1704296083,36,COMPLETED
5319303,1,1,1704296046,1704296047,1704296083,36,COMPLETED
5319304,1,1,1704296046,1704296047,1704296084,37,COMPLETED
5319305,1,1,1704296059,1704296059,1704296115,56,COMPLETED
5319306,1,1,1704296059,1704296059,1704296113,54,COMPLETED
5319307,1,1,1704296060,1704296060,1704296117,57,COMPLETED
5319308,1,1,1704296060,1704296060,1704296113,53,COMPLETED
5319309,1,1,1704296060,1704296060,1704296113,53,COMPLETED
5319310,1,1,1704296060,1704296060,1704296113,53,COMPLETED
5319311,1,1,1704296060,1704296060,1704296113,53,COMPLETED
5319312,1,1,1704296060,1704296060,1704296114,54,COMPLETED
5319313,1,1,1704296060,1704296060,1704296113,53,COMPLETED
5319314,1,1,1704296060,1704296060,1704296113,53,COMPLETED
5319315,1,1,1704296060,1704296060,1704296113,53,COMPLETED
5319316,1,1,1704296060,1704296060,1704296113,53,COMPLETED
5319317,1,1,1704296060,1704296060,1704296114,54,COMPLETED
5319318,1,1,1704296060,1704296060,1704296120,60,COMPLETED
5319319,1,1,1704296060,1704296060,1704296113,53,COMPLETED
5319320,1,1,1704296060,1704296060,1704296113,53,COMPLETED
5319321,1,1,1704296060,1704296060,1704296115,55,COMPLETED
5319322,1,1,1704296060,1704296060,1704296113,53,COMPLETED
5319323,1,1,1704296061,1704296061,1704296113,52,COMPLETED
5319324,1,1,1704296061,1704296061,1704296117,56,COMPLETED
5319325,1,1,1704296061,1704296061,1704296118,57,COMPLETED
5319326,1,1,1704296061,1704296061,1704296117,56,COMPLETED
5319327,1,1,1704296061,1704296061,1704296117,56,COMPLETED
5319328,1,1,1704296061,1704296061,1704296118,57,COMPLETED
5319329,1,1,1704296061,1704296061,1704296117,56,COMPLETED
5319330,1,1,1704296061,1704296061,1704296118,57,COMPLETED
5319331,1,1,1704296061,1704296061,1704296125,64,COMPLETED
5319332,1,1,1704296061,1704296061,1704296116,55,COMPLETED
5319333,1,1,1704296062,1704296062,1704296113,51,COMPLETED
5319334,1,1,1704296062,1704296062,1704296117,55,COMPLETED
5319335,1,1,1704296062,1704296062,1704296113,51,COMPLETED
5319336,1,1,1704296062,1704296062,1704296113,51,COMPLETED
5319337,1,1,1704296062,1704296062,1704296113,51,COMPLETED
5319338,1,1,1704296062,1704296062,1704296113,51,COMPLETED
5319339,1,1,1704296062,1704296062,1704296113,51,COMPLETED
5319340,1,1,1704296062,1704296062,1704296113,51,COMPLETED
5319341,1,1,1704296062,1704296062,1704296113,51,COMPLETED
5319342,1,1,1704296062,1704296062,1704296113,51,COMPLETED
5319343,1,1,1704296063,1704296064,1704296114,50,COMPLETED
5319344,1,1,1704296063,1704296064,1704296113,49,COMPLETED
5319345,1,1,1704296063,1704296064,1704296113,49,COMPLETED
5319346,1,1,1704296063,1704296064,1704296113,49,COMPLETED
5319347,1,1,1704296063,1704296064,1704296113,49,COMPLETED
5319348,1,1,1704296063,1704296064,1704296118,54,COMPLETED
5319349,1,1,1704296063,1704296064,1704296116,52,COMPLETED
5319350,1,1,1704296063,1704296064,1704296117,53,COMPLETED
5319351,1,1,1704296063,1704296064,1704296117,53,COMPLETED
5319352,1,1,1704296063,1704296064,1704296117,53,COMPLETED
5319353,1,1,1704296064,1704296066,1704296115,49,COMPLETED
5319354,1,1,1704296064,1704296066,1704296114,48,COMPLETED
5319355,1,1,1704296064,1704296066,1704296114,48,COMPLETED
5319356,1,1,1704296064,1704296066,1704296113,47,COMPLETED
5319357,1,1,1704296064,1704296066,1704296114,48,COMPLETED
5319358,1,1,1704296064,1704296066,1704296114,48,COMPLETED
5319359,1,1,1704296064,1704296066,1704296115,49,COMPLETED
5319360,1,1,1704296064,1704296066,1704296113,47,COMPLETED
5319361,1,1,1704296065,1704296066,1704296117,51,COMPLETED
5319362,1,1,1704296065,1704296066,1704296114,48,COMPLETED
5319363,1,1,1704296065,1704296066,1704296115,49,COMPLETED
5319364,1,1,1704296065,1704296066,1704296114,48,COMPLETED
5319365,1,1,1704296065,1704296066,1704296113,47,COMPLETED
5319366,1,1,1704296065,1704296066,1704296114,48,COMPLETED
5319367,1,1,1704296065,1704296066,1704296115,49,COMPLETED
5319368,1,1,1704296065,1704296066,1704296120,54,COMPLETED
5319369,1,1,1704296065,1704296066,1704296117,51,COMPLETED
5319370,1,1,1704296065,1704296066,1704296118,52,COMPLETED
5319371,1,1,1704296065,1704296066,1704296118,52,COMPLETED
5319372,1,1,1704296065,1704296066,1704296119,53,COMPLETED
5319373,1,1,1704296066,1704296066,1704296117,51,COMPLETED
5319374,1,1,1704296066,1704296066,1704296118,52,COMPLETED
5319375,1,1,1704296066,1704296066,1704296117,51,COMPLETED
5319376,1,1,1704296066,1704296066,1704296119,53,COMPLETED
5319377,1,1,1704296066,1704296066,1704296117,51,COMPLETED
5319378,1,1,1704296066,1704296066,1704296117,51,COMPLETED
5319379,1,1,1704296066,1704296066,1704296118,52,COMPLETED
5319380,1,1,1704296066,1704296066,1704296118,52,COMPLETED
5319381,1,1,1704296066,1704296066,1704296117,51,COMPLETED
5319382,1,1,1704296066,1704296066,1704296118,52,COMPLETED
5319383,1,1,1704296067,1704296070,1704296118,48,COMPLETED
5319384,1,1,1704296068,1704296070,1704296119,49,COMPLETED
5319385,1,1,1704296068,1704296070,1704296118,48,COMPLETED
5319386,1,1,1704296068,1704296070,1704296117,47,COMPLETED
5319387,1,1,1704296068,1704296070,1704296118,48,COMPLETED
5319388,1,1,1704296069,1704296070,1704296117,47,COMPLETED
5319389,1,1,1704296069,1704296070,1704296118,48,COMPLETED
5319390,1,1,1704296069,1704296070,1704296118,48,COMPLETED
5319391,1,1,1704296069,1704296070,1704296117,47,COMPLETED
5319392,1,1,1704296069,1704296070,1704296119,49,COMPLETED
5319393,1,1,1704296069,1704296070,1704296119,49,COMPLETED
5319394,1,1,1704296069,1704296070,1704296119,49,COMPLETED
5319395,1,1,1704296069,1704296070,1704296119,49,COMPLETED
5319396,1,1,1704296069,1704296070,1704296119,49,COMPLETED
5319397,1,1,1704296069,1704296070,1704296119,49,COMPLETED
5319398,1,1,1704296069,1704296070,1704296117,47,COMPLETED
5319399,1,1,1704296069,1704296070,1704296119,49,COMPLETED
5319400,1,1,1704296069,1704296070,1704296120,50,COMPLETED
5319401,1,1,1704296069,1704296070,1704296117,47,COMPLETED
5319402,1,1,1704296069,1704296070,1704296118,48,COMPLETED
5319403,1,1,1704296069,1704296070,1704296119,49,COMPLETED
5319404,1,1,1704296070,1704296070,1704296119,49,COMPLETED
5319405,1,1,1704296070,1704296070,1704296119,49,COMPLETED
5319406,1,1,1704296070,1704296070,1704296116,46,COMPLETED
5319407,1,1,1704296070,1704296070,1704296118,48,COMPLETED
5319408,1,1,1704296070,1704296070,1704296119,49,COMPLETED
5319409,1,1,1704296070,1704296070,1704296118,48,COMPLETED
5319410,1,1,1704296070,1704296070,1704296117,47,COMPLETED
5319411,1,1,1704296070,1704296070,1704296119,49,COMPLETED
5319412,1,1,1704296070,1704296070,1704296117,47,COMPLETED
5319413,1,1,1704296071,1704296071,1704296116,45,COMPLETED
5319414,1,1,1704296071,1704296071,1704296119,48,COMPLETED
5319415,1,1,1704296071,1704296071,1704296117,46,COMPLETED
5319416,1,1,1704296071,1704296071,1704296118,47,COMPLETED
5319417,1,1,1704296071,1704296071,1704296119,48,COMPLETED
5319418,1,1,1704296071,1704296071,1704296117,46,COMPLETED
5319419,1,1,1704296071,1704296071,1704296119,48,COMPLETED
5319420,1,1,1704296071,1704296071,1704296118,47,COMPLETED
5319421,1,1,1704296071,1704296071,1704296118,47,COMPLETED
5319422,1,1,1704296071,1704296072,1704296116,44,COMPLETED
5319423,1,1,1704296071,1704296072,1704296117,45,COMPLETED
5319424,1,1,1704296072,1704296072,1704296117,45,COMPLETED
5319425,1,1,1704296072,1704296072,1704296113,41,COMPLETED
5319426,1,1,1704296072,1704296072,1704296113,41,COMPLETED
5319427,1,1,1704296072,1704296072,1704296113,41,COMPLETED
5319428,1,1,1704296072,1704296072,1704296113,41,COMPLETED
5319429,1,1,1704296072,1704296072,1704296113,41,COMPLETED
5319430,1,1,1704296072,1704296072,1704296113,41,COMPLETED
5319431,1,1,1704296072,1704296072,1704296113,41,COMPLETED
5319432,1,1,1704296073,1704296074,1704296113,39,COMPLETED
5319433,1,1,1704296073,1704296074,1704296115,41,COMPLETED
5319434,1,1,1704296073,1704296074,1704296113,39,COMPLETED
5319435,1,1,1704296073,1704296074,1704296116,42,COMPLETED
5319436,1,1,1704296073,1704296074,1704296113,39,COMPLETED
5319437,1,1,1704296073,1704296074,1704296116,42,COMPLETED
5319438,1,1,1704296073,1704296074,1704296114,40,COMPLETED
5319439,1,1,1704296074,1704296074,1704296113,39,COMPLETED
5319440,1,1,1704296074,1704296074,1704296113,39,COMPLETED
5319441,1,1,1704296074,1704296074,1704296113,39,COMPLETED
5319442,1,1,1704296074,1704296074,1704296113,39,COMPLETED
5319443,1,1,1704296074,1704296074,1704296113,39,COMPLETED
5319444,1,1,1704296074,1704296074,1704296113,39,COMPLETED
5319445,1,1,1704296074,1704296074,1704296113,39,COMPLETED
5319446,1,1,1704296074,1704296074,1704296113,39,COMPLETED
5319447,1,1,1704296074,1704296074,1704296113,39,COMPLETED
5319448,1,1,1704296074,1704296074,1704296113,39,COMPLETED
5319449,1,1,1704296074,1704296074,1704296113,39,COMPLETED
5319450,36,1,1704296111,1704296111,1704296514,403,COMPLETED
5319451,36,1,1704296119,1704296119,1704296703,584,FAILED
5319452,1,1,1704296184,1704296186,1704296242,56,COMPLETED
5319453,1,1,1704296184,1704296186,1704296239,53,COMPLETED
5319454,1,1,1704296184,1704296186,1704296242,56,COMPLETED
5319455,1,1,1704296184,1704296186,1704296238,52,COMPLETED
5319456,1,1,1704296184,1704296186,1704296241,55,COMPLETED
5319457,1,1,1704296185,1704296186,1704296239,53,COMPLETED
5319458,1,1,1704296185,1704296186,1704296238,52,COMPLETED
5319459,1,1,1704296185,1704296186,1704296238,52,COMPLETED
5319460,1,1,1704296185,1704296186,1704296238,52,COMPLETED
5319461,1,1,1704296185,1704296186,1704296239,53,COMPLETED
5319462,1,1,1704296185,1704296186,1704296239,53,COMPLETED
5319463,1,1,1704296185,1704296186,1704296238,52,COMPLETED
5319464,1,1,1704296185,1704296186,1704296238,52,COMPLETED
5319465,1,1,1704296185,1704296186,1704296240,54,COMPLETED
5319466,1,1,1704296185,1704296186,1704296242,56,COMPLETED
5319467,1,1,1704296185,1704296186,1704296238,52,COMPLETED
5319468,1,1,1704296185,1704296186,1704296240,54,COMPLETED
5319469,1,1,1704296185,1704296186,1704296239,53,COMPLETED
5319470,1,1,1704296185,1704296186,1704296239,53,COMPLETED
5319471,1,1,1704296185,1704296186,1704296238,52,COMPLETED
5319472,1,1,1704296185,1704296186,1704296238,52,COMPLETED
5319473,1,1,1704296185,1704296186,1704296238,52,COMPLETED
5319474,1,1,1704296185,1704296186,1704296238,52,COMPLETED
5319475,1,1,1704296185,1704296186,1704296238,52,COMPLETED
5319476,1,1,1704296185,1704296186,1704296240,54,COMPLETED
5319477,1,1,1704296185,1704296186,1704296239,53,COMPLETED
5319478,1,1,1704296185,1704296186,1704296238,52,COMPLETED
5319479,1,1,1704296185,1704296186,1704296238,52,COMPLETED
5319480,1,1,1704296185,1704296186,1704296239,53,COMPLETED
5319481,1,1,1704296185,1704296186,1704296241,55,COMPLETED
5319482,1,1,1704296185,1704296186,1704296239,53,COMPLETED
5319483,1,1,1704296185,1704296186,1704296239,53,COMPLETED
5319484,1,1,1704296185,1704296186,1704296240,54,COMPLETED
5319485,1,1,1704296185,1704296186,1704296240,54,COMPLETED
5319486,1,1,1704296185,1704296186,1704296238,52,COMPLETED
5319487,1,1,1704296185,1704296186,1704296238,52,COMPLETED
5319488,1,1,1704296185,1704296186,1704296241,55,COMPLETED
5319489,1,1,1704296185,1704296186,1704296238,52,COMPLETED
5319490,1,1,1704296185,1704296186,1704296240,54,COMPLETED
5319491,1,1,1704296185,1704296186,1704296238,52,COMPLETED
5319492,1,1,1704296185,1704296186,1704296238,52,COMPLETED
5319493,1,1,1704296185,1704296186,1704296238,52,COMPLETED
5319494,1,1,1704296185,1704296186,1704296238,52,COMPLETED
5319495,1,1,1704296186,1704296186,1704296239,53,COMPLETED
5319496,1,1,1704296186,1704296186,1704296240,54,COMPLETED
5319497,1,1,1704296186,1704296186,1704296238,52,COMPLETED
5319498,1,1,1704296186,1704296186,1704296240,54,COMPLETED
5319499,1,1,1704296186,1704296186,1704296238,52,COMPLETED
5319500,1,1,1704296186,1704296186,1704296238,52,COMPLETED
5319501,1,1,1704296186,1704296186,1704296238,52,COMPLETED
5319502,1,1,1704296186,1704296186,1704296240,54,COMPLETED
5319503,1,1,1704296186,1704296186,1704296238,52,COMPLETED
5319504,1,1,1704296186,1704296186,1704296238,52,COMPLETED
5319505,1,1,1704296186,1704296186,1704296238,52,COMPLETED
5319506,1,1,1704296186,1704296186,1704296238,52,COMPLETED
5319507,1,1,1704296186,1704296186,1704296239,53,COMPLETED
5319508,1,1,1704296186,1704296186,1704296238,52,COMPLETED
5319509,1,1,1704296186,1704296186,1704296238,52,COMPLETED
5319510,1,1,1704296186,1704296186,1704296238,52,COMPLETED
5319511,1,1,1704296186,1704296186,1704296240,54,COMPLETED
5319512,1,1,1704296186,1704296186,1704296238,52,COMPLETED
5319513,1,1,1704296186,1704296186,1704296238,52,COMPLETED
5319514,1,1,1704296186,1704296186,1704296241,55,COMPLETED
5319515,1,1,1704296186,1704296186,1704296243,57,COMPLETED
5319516,1,1,1704296186,1704296186,1704296241,55,COMPLETED
5319517,1,1,1704296186,1704296186,1704296238,52,COMPLETED
5319518,1,1,1704296186,1704296186,1704296240,54,COMPLETED
5319519,1,1,1704296186,1704296186,1704296238,52,COMPLETED
5319520,1,1,1704296186,1704296186,1704296238,52,COMPLETED
5319521,1,1,1704296186,1704296186,1704296241,55,COMPLETED
5319522,1,1,1704296186,1704296186,1704296238,52,COMPLETED
5319523,1,1,1704296186,1704296186,1704296241,55,COMPLETED
5319524,1,1,1704296186,1704296186,1704296240,54,COMPLETED
5319525,1,1,1704296186,1704296186,1704296239,53,COMPLETED
5319526,1,1,1704296186,1704296186,1704296239,53,COMPLETED
5319527,1,1,1704296186,1704296186,1704296239,53,COMPLETED
5319528,1,1,1704296186,1704296190,1704296239,49,COMPLETED
5319529,1,1,1704296186,1704296190,1704296240,50,COMPLETED
5319530,1,1,1704296187,1704296190,1704296239,49,COMPLETED
5319531,1,1,1704296187,1704296190,1704296239,49,COMPLETED
5319532,1,1,1704296187,1704296190,1704296242,52,COMPLETED
5319533,1,1,1704296187,1704296190,1704296243,53,COMPLETED
5319534,1,1,1704296187,1704296190,1704296239,49,COMPLETED
5319535,1,1,1704296187,1704296190,1704296241,51,COMPLETED
5319536,1,1,1704296187,1704296190,1704296241,51,COMPLETED
5319537,1,1,1704296187,1704296190,1704296239,49,COMPLETED
5319538,1,1,1704296187,1704296190,1704296239,49,COMPLETED
5319539,1,1,1704296187,1704296190,1704296241,51,COMPLETED
5319540,1,1,1704296187,1704296190,1704296239,49,COMPLETED
5319541,1,1,1704296187,1704296190,1704296244,54,COMPLETED
5319542,1,1,1704296187,1704296190,1704296241,51,COMPLETED
5319543,1,1,1704296187,1704296190,1704296239,49,COMPLETED
5319544,1,1,1704296187,1704296190,1704296241,51,COMPLETED
5319545,1,1,1704296187,1704296190,1704296239,49,COMPLETED
5319546,1,1,1704296187,1704296190,1704296239,49,COMPLETED
5319547,1,1,1704296187,1704296190,1704296239,49,COMPLETED
5319548,1,1,1704296187,1704296190,1704296241,51,COMPLETED
5319549,1,1,1704296187,1704296190,1704296239,49,COMPLETED
5319550,1,1,1704296187,1704296190,1704296239,49,COMPLETED
5319551,1,1,1704296187,1704296190,1704296240,50,COMPLETED
5319552,1,1,1704296187,1704296190,1704296239,49,COMPLETED
5319553,1,1,1704296188,1704296190,1704296239,49,COMPLETED
5319554,1,1,1704296188,1704296190,1704296245,55,COMPLETED
5319555,1,1,1704296188,1704296190,1704296241,51,COMPLETED
5319556,1,1,1704296188,1704296190,1704296239,49,COMPLETED
5319557,1,1,1704296188,1704296190,1704296241,51,COMPLETED
5319558,1,1,1704296188,1704296190,1704296239,49,COMPLETED
5319559,1,1,1704296188,1704296190,1704296242,52,COMPLETED
5319560,1,1,1704296188,1704296190,1704296239,49,COMPLETED
5319561,1,1,1704296188,1704296190,1704296238,48,COMPLETED
5319562,1,1,1704296188,1704296190,1704296241,51,COMPLETED
5319563,1,1,1704296188,1704296190,1704296238,48,COMPLETED
5319564,1,1,1704296188,1704296190,1704296238,48,COMPLETED
5319565,1,1,1704296188,1704296190,1704296239,49,COMPLETED
5319566,1,1,1704296188,1704296190,1704296238,48,COMPLETED
5319567,1,1,1704296188,1704296190,1704296238,48,COMPLETED
5319568,1,1,1704296188,1704296190,1704296241,51,COMPLETED
5319569,1,1,1704296188,1704296190,1704296243,53,COMPLETED
5319570,1,1,1704296188,1704296190,1704296238,48,COMPLETED
5319571,1,1,1704296188,1704296190,1704296238,48,COMPLETED
5319572,1,1,1704296188,1704296190,1704296240,50,COMPLETED
5319573,1,1,1704296188,1704296190,1704296240,50,COMPLETED
5319574,1,1,1704296188,1704296190,1704296238,48,COMPLETED
5319575,1,1,1704296188,1704296190,1704296239,49,COMPLETED
5319576,1,1,1704296188,1704296190,1704296242,52,COMPLETED
5319577,1,1,1704296188,1704296190,1704296242,52,COMPLETED
5319578,1,1,1704296188,1704296190,1704296241,51,COMPLETED
5319579,1,1,1704296188,1704296190,1704296238,48,COMPLETED
5319580,1,1,1704296188,1704296190,1704296238,48,COMPLETED
5319581,1,1,1704296188,1704296190,1704296238,48,COMPLETED
5319582,1,1,1704296188,1704296190,1704296238,48,COMPLETED
5319583,1,1,1704296188,1704296190,1704296241,51,COMPLETED
5319584,1,1,1704296188,1704296190,1704296241,51,COMPLETED
5319585,1,1,1704296188,1704296190,1704296241,51,COMPLETED
5319586,1,1,1704296188,1704296190,1704296238,48,COMPLETED
5319587,1,1,1704296188,1704296190,1704296239,49,COMPLETED
5319588,1,1,1704296188,1704296190,1704296243,53,COMPLETED
5319589,1,1,1704296188,1704296190,1704296239,49,COMPLETED
5319590,1,1,1704296188,1704296190,1704296238,48,COMPLETED
5319591,1,1,1704296189,1704296190,1704296238,48,COMPLETED
5319592,1,1,1704296189,1704296190,1704296240,50,COMPLETED
5319593,1,1,1704296189,1704296190,1704296238,48,COMPLETED
5319594,1,1,1704296189,1704296190,1704296238,48,COMPLETED
5319595,1,1,1704296189,1704296190,1704296242,52,COMPLETED
5319596,1,1,1704296189,1704296190,1704296238,48,COMPLETED
5319597,1,1,1704296189,1704296190,1704296241,51,COMPLETED
5319598,1,1,1704296189,1704296190,1704296239,49,COMPLETED
5319599,1,1,1704296189,1704296190,1704296238,48,COMPLETED
5319600,1,1,1704296189,1704296190,1704296241,51,COMPLETED
5319601,1,1,1704296189,1704296190,1704296238,48,COMPLETED
5319602,1,1,1704296189,1704296190,1704296238,48,COMPLETED
5319603,1,1,1704296189,1704296190,1704296238,48,COMPLETED
5319604,1,1,1704296189,1704296190,1704296238,48,COMPLETED
5319605,1,1,1704296189,1704296190,1704296241,51,COMPLETED
5319606,1,1,1704296189,1704296190,1704296241,51,COMPLETED
5319607,1,1,1704296189,1704296190,1704296238,48,COMPLETED
5319608,1,1,1704296189,1704296190,1704296238,48,COMPLETED
5319609,1,1,1704296189,1704296190,1704296238,48,COMPLETED
5319610,1,1,1704296189,1704296190,1704296238,48,COMPLETED
5319611,1,1,1704296189,1704296190,1704296238,48,COMPLETED
5319612,1,1,1704296189,1704296190,1704296238,48,COMPLETED
5319613,1,1,1704296189,1704296190,1704296239,49,COMPLETED
5319614,1,1,1704296189,1704296190,1704296240,50,COMPLETED
5319615,1,1,1704296189,1704296190,1704296238,48,COMPLETED
5319616,1,1,1704296189,1704296190,1704296238,48,COMPLETED
5319617,1,1,1704296189,1704296190,1704296238,48,COMPLETED
5319618,1,1,1704296189,1704296190,1704296241,51,COMPLETED
5319619,1,1,1704296189,1704296190,1704296238,48,COMPLETED
5319620,1,1,1704296189,1704296190,1704296238,48,COMPLETED
5319621,1,1,1704296189,1704296190,1704296241,51,COMPLETED
5319622,1,1,1704296189,1704296190,1704296238,48,COMPLETED
5319623,1,1,1704296189,1704296190,1704296241,51,COMPLETED
5319624,1,1,1704296189,1704296190,1704296239,49,COMPLETED
5319625,1,1,1704296189,1704296190,1704296241,51,COMPLETED
5319626,1,1,1704296189,1704296190,1704296238,48,COMPLETED
5319627,1,1,1704296189,1704296190,1704296239,49,COMPLETED
5319628,1,1,1704296189,1704296190,1704296241,51,COMPLETED
5319629,1,1,1704296189,1704296190,1704296238,48,COMPLETED
5319630,1,1,1704296189,1704296190,1704296241,51,COMPLETED
5319631,1,1,1704296189,1704296190,1704296238,48,COMPLETED
5319632,1,1,1704296189,1704296190,1704296238,48,COMPLETED
5319633,1,1,1704296189,1704296190,1704296238,48,COMPLETED
5319634,1,1,1704296189,1704296190,1704296240,50,COMPLETED
5319635,1,1,1704296190,1704296190,1704296238,48,COMPLETED
5319636,1,1,1704296190,1704296190,1704296238,48,COMPLETED
5319637,1,1,1704296190,1704296190,1704296238,48,COMPLETED
5319638,1,1,1704296190,1704296190,1704296238,48,COMPLETED
5319639,1,1,1704296190,1704296190,1704296238,48,COMPLETED
5319640,1,1,1704296190,1704296190,1704296238,48,COMPLETED
5319641,1,1,1704296190,1704296190,1704296238,48,COMPLETED
5319642,1,1,1704296190,1704296190,1704296238,48,COMPLETED
5319643,1,1,1704296190,1704296190,1704296239,49,COMPLETED
5319644,1,1,1704296190,1704296190,1704296238,48,COMPLETED
5319645,1,1,1704296190,1704296190,1704296238,48,COMPLETED
5319646,1,1,1704296190,1704296190,1704296238,48,COMPLETED
5319647,1,1,1704296190,1704296190,1704296238,48,COMPLETED
5319648,1,1,1704296190,1704296190,1704296238,48,COMPLETED
5319649,1,1,1704296190,1704296190,1704296239,49,COMPLETED
5319650,1,1,1704296190,1704296190,1704296238,48,COMPLETED
5319651,1,1,1704296190,1704296190,1704296238,48,COMPLETED
5319652,1,1,1704296239,1704296239,1704296270,31,COMPLETED
5319653,1,1,1704296239,1704296239,1704296270,31,COMPLETED
5319654,1,1,1704296239,1704296239,1704296271,32,COMPLETED
5319655,1,1,1704296239,1704296239,1704296270,31,COMPLETED
5319656,1,1,1704296239,1704296239,1704296271,32,COMPLETED
5319657,1,1,1704296239,1704296239,1704296273,34,COMPLETED
5319658,1,1,1704296239,1704296239,1704296271,32,COMPLETED
5319659,1,1,1704296239,1704296239,1704296273,34,COMPLETED
5319660,1,1,1704296239,1704296239,1704296273,34,COMPLETED
5319661,1,1,1704296239,1704296239,1704296271,32,COMPLETED
5319662,1,1,1704296239,1704296240,1704296270,30,COMPLETED
5319663,1,1,1704296240,1704296240,1704296273,33,COMPLETED
5319664,1,1,1704296240,1704296240,1704296270,30,COMPLETED
5319665,1,1,1704296240,1704296240,1704296272,32,COMPLETED
5319666,1,1,1704296240,1704296240,1704296271,31,COMPLETED
5319667,1,1,1704296240,1704296240,1704296270,30,COMPLETED
5319668,1,1,1704296240,1704296240,1704296271,31,COMPLETED
5319669,1,1,1704296240,1704296240,1704296270,30,COMPLETED
5319670,1,1,1704296240,1704296240,1704296270,30,COMPLETED
5319671,1,1,1704296249,1704296250,1704296271,21,COMPLETED
5319672,1,1,1704296250,1704296254,1704296283,29,COMPLETED
5319673,1,1,1704296251,1704296254,1704296283,29,COMPLETED
5319674,1,1,1704296251,1704296254,1704296283,29,COMPLETED
5319675,1,1,1704296251,1704296254,1704296282,28,COMPLETED
5319676,1,1,1704296251,1704296254,1704296281,27,COMPLETED
5319677,1,1,1704296251,1704296254,1704296283,29,COMPLETED
5319678,1,1,1704296251,1704296254,1704296283,29,COMPLETED
5319679,1,1,1704296251,1704296254,1704296283,29,COMPLETED
5319680,1,1,1704296251,1704296254,1704296284,30,COMPLETED
5319681,1,1,1704296251,1704296254,1704296281,27,COMPLETED
5319682,1,1,1704296252,1704296254,1704296281,27,COMPLETED
5319683,1,1,1704296252,1704296254,1704296281,27,COMPLETED
5319684,1,1,1704296252,1704296254,1704296283,29,COMPLETED
5319685,1,1,1704296252,1704296254,1704296282,28,COMPLETED
5319686,1,1,1704296252,1704296254,1704296281,27,COMPLETED
5319687,1,1,1704296252,1704296254,1704296284,30,COMPLETED
5319688,1,1,1704296252,1704296254,1704296283,29,COMPLETED
5319689,1,1,1704296252,1704296254,1704296283,29,COMPLETED
5319690,1,1,1704296252,1704296254,1704296281,27,COMPLETED
5319691,1,1,1704296252,1704296254,1704296283,29,COMPLETED
5319692,1,1,1704296252,1704296254,1704296283,29,COMPLETED
5319693,1,1,1704296253,1704296254,1704296281,27,COMPLETED
5319694,1,1,1704296253,1704296254,1704296281,27,COMPLETED
5319695,1,1,1704296253,1704296254,1704296283,29,COMPLETED
5319696,1,1,1704296253,1704296254,1704296283,29,COMPLETED
5319697,1,1,1704296253,1704296254,1704296281,27,COMPLETED
5319698,1,1,1704296253,1704296254,1704296283,29,COMPLETED
5319699,1,1,1704296253,1704296254,1704296281,27,COMPLETED
5319700,1,1,1704296253,1704296254,1704296283,29,COMPLETED
5319701,1,1,1704296253,1704296254,1704296282,28,COMPLETED
5319702,1,1,1704296254,1704296254,1704296281,27,COMPLETED
5319703,1,1,1704296254,1704296254,1704296281,27,COMPLETED
5319704,1,1,1704296254,1704296254,1704296281,27,COMPLETED
5319705,1,1,1704296254,1704296258,1704296287,29,COMPLETED
5319706,1,1,1704296254,1704296258,1704296287,29,COMPLETED
5319707,1,1,1704296254,1704296258,1704296291,33,COMPLETED
5319708,1,1,1704296254,1704296258,1704296291,33,COMPLETED
5319709,1,1,1704296254,1704296258,1704296291,33,COMPLETED
5319710,1,1,1704296254,1704296258,1704296291,33,COMPLETED
5319711,1,1,1704296254,1704296258,1704296291,33,COMPLETED
5319712,1,1,1704296255,1704296258,1704296291,33,COMPLETED
5319713,1,1,1704296255,1704296258,1704296291,33,COMPLETED
5319714,1,1,1704296255,1704296258,1704296287,29,COMPLETED
5319715,1,1,1704296255,1704296258,1704296291,33,COMPLETED
5319716,1,1,1704296255,1704296258,1704296291,33,COMPLETED
5319717,1,1,1704296255,1704296258,1704296291,33,COMPLETED
5319718,1,1,1704296255,1704296258,1704296291,33,COMPLETED
5319719,1,1,1704296255,1704296258,1704296291,33,COMPLETED
5319720,1,1,1704296255,1704296258,1704296291,33,COMPLETED
5319721,1,1,1704296255,1704296258,1704296291,33,COMPLETED
5319722,1,1,1704296255,1704296258,1704296291,33,COMPLETED
5319723,1,1,1704296256,1704296258,1704296291,33,COMPLETED
5319724,1,1,1704296256,1704296258,1704296288,30,COMPLETED
5319725,1,1,1704296256,1704296258,1704296292,34,COMPLETED
5319726,1,1,1704296256,1704296258,1704296287,29,COMPLETED
5319727,1,1,1704296256,1704296258,1704296291,33,COMPLETED
5319728,1,1,1704296256,1704296258,1704296291,33,COMPLETED
5319729,1,1,1704296256,1704296258,1704296291,33,COMPLETED
5319730,1,1,1704296256,1704296258,1704296288,30,COMPLETED
5319731,1,1,1704296256,1704296258,1704296291,33,COMPLETED
5319732,1,1,1704296257,1704296258,1704296291,33,COMPLETED
5319733,1,1,1704296257,1704296258,1704296291,33,COMPLETED
5319734,1,1,1704296257,1704296258,1704296291,33,COMPLETED
5319735,1,1,1704296257,1704296258,1704296292,34,COMPLETED
5319736,1,1,1704296257,1704296258,1704296291,33,COMPLETED
5319737,1,1,1704296257,1704296258,1704296292,34,COMPLETED
5319738,1,1,1704296257,1704296258,1704296292,34,COMPLETED
5319739,1,1,1704296257,1704296258,1704296292,34,COMPLETED
5319740,1,1,1704296257,1704296258,1704296291,33,COMPLETED
5319741,1,1,1704296257,1704296258,1704296291,33,COMPLETED
5319742,1,1,1704296258,1704296258,1704296292,34,COMPLETED
5319743,1,1,1704296258,1704296258,1704296281,23,COMPLETED
5319744,1,1,1704296258,1704296258,1704296281,23,COMPLETED
5319745,1,1,1704296258,1704296258,1704296281,23,COMPLETED
5319746,1,1,1704296258,1704296258,1704296281,23,COMPLETED
5319747,1,1,1704296258,1704296258,1704296281,23,COMPLETED
5319748,1,1,1704296258,1704296258,1704296281,23,COMPLETED
5319749,1,1,1704296258,1704296262,1704296314,52,COMPLETED
5319750,1,1,1704296258,1704296262,1704296312,50,COMPLETED
5319751,1,1,1704296258,1704296262,1704296312,50,COMPLETED
5319752,1,1,1704296259,1704296262,1704296311,49,COMPLETED
5319753,1,1,1704296259,1704296262,1704296311,49,COMPLETED
5319754,1,1,1704296259,1704296262,1704296311,49,COMPLETED
5319755,1,1,1704296259,1704296262,1704296311,49,COMPLETED
5319756,1,1,1704296259,1704296262,1704296313,51,COMPLETED
5319757,1,1,1704296259,1704296262,1704296312,50,COMPLETED
5319758,1,1,1704296259,1704296262,1704296311,49,COMPLETED
5319759,1,1,1704296259,1704296262,1704296314,52,COMPLETED
5319760,1,1,1704296259,1704296262,1704296311,49,COMPLETED
5319761,1,1,1704296259,1704296262,1704296312,50,COMPLETED
5319762,1,1,1704296260,1704296262,1704296313,51,COMPLETED
5319763,1,1,1704296260,1704296262,1704296314,52,COMPLETED
5319764,1,1,1704296260,1704296262,1704296311,49,COMPLETED
5319765,1,1,1704296260,1704296262,1704296311,49,COMPLETED
5319766,1,1,1704296260,1704296262,1704296311,49,COMPLETED
5319767,1,1,1704296260,1704296262,1704296311,49,COMPLETED
5319768,1,1,1704296260,1704296262,1704296311,49,COMPLETED
5319769,1,1,1704296260,1704296262,1704296311,49,COMPLETED
5319770,1,1,1704296260,1704296262,1704296312,50,COMPLETED
5319771,1,1,1704296260,1704296262,1704296311,49,COMPLETED
5319772,1,1,1704296261,1704296262,1704296312,50,COMPLETED
5319774,1,1,1704296261,1704296262,1704296311,49,COMPLETED
5319775,1,1,1704296261,1704296262,1704296312,50,COMPLETED
5319776,1,1,1704296261,1704296262,1704296311,49,COMPLETED
5319777,1,1,1704296261,1704296262,1704296311,49,COMPLETED
5319778,1,1,1704296261,1704296262,1704296311,49,COMPLETED
5319779,1,1,1704296261,1704296262,1704296313,51,COMPLETED
5319780,1,1,1704296261,1704296262,1704296313,51,COMPLETED
5319781,1,1,1704296261,1704296262,1704296315,53,COMPLETED
5319773,1,1,1704296261,1704296262,1704296460,198,COMPLETED
5319782,1,1,1704296262,1704296262,1704296316,54,COMPLETED
5319783,1,1,1704296262,1704296266,1704296312,46,COMPLETED
5319784,1,1,1704296262,1704296266,1704296313,47,COMPLETED
5319785,1,1,1704296262,1704296266,1704296313,47,COMPLETED
5319786,1,1,1704296262,1704296266,1704296312,46,COMPLETED
5319787,1,1,1704296262,1704296266,1704296314,48,COMPLETED
5319788,1,1,1704296262,1704296266,1704296312,46,COMPLETED
5319789,1,1,1704296262,1704296266,1704296314,48,COMPLETED
5319790,1,1,1704296262,1704296266,1704296315,49,COMPLETED
5319791,1,1,1704296262,1704296266,1704296315,49,COMPLETED
5319792,1,1,1704296263,1704296266,1704296313,47,COMPLETED
5319793,1,1,1704296263,1704296266,1704296312,46,COMPLETED
5319794,1,1,1704296263,1704296266,1704296312,46,COMPLETED
5319795,1,1,1704296263,1704296266,1704296315,49,COMPLETED
5319796,1,1,1704296263,1704296266,1704296314,48,COMPLETED
5319797,1,1,1704296263,1704296266,1704296314,48,COMPLETED
5319798,1,1,1704296263,1704296266,1704296314,48,COMPLETED
5319799,1,1,1704296263,1704296266,1704296313,47,COMPLETED
5319800,1,1,1704296263,1704296266,1704296313,47,COMPLETED
5319801,1,1,1704296263,1704296266,1704296315,49,COMPLETED
5319802,1,1,1704296263,1704296266,1704296312,46,COMPLETED
5319803,1,1,1704296264,1704296266,1704296312,46,COMPLETED
5319804,1,1,1704296264,1704296266,1704296313,47,COMPLETED
5319805,1,1,1704296264,1704296266,1704296313,47,COMPLETED
5319806,1,1,1704296264,1704296266,1704296313,47,COMPLETED
5319807,1,1,1704296264,1704296266,1704296315,49,COMPLETED
5319808,1,1,1704296264,1704296266,1704296312,46,COMPLETED
5319809,1,1,1704296264,1704296266,1704296315,49,COMPLETED
5319810,1,1,1704296264,1704296266,1704296313,47,COMPLETED
5319811,1,1,1704296264,1704296266,1704296312,46,COMPLETED
5319812,1,1,1704296265,1704296266,1704296312,46,COMPLETED
5319813,1,1,1704296265,1704296266,1704296312,46,COMPLETED
5319814,1,1,1704296265,1704296266,1704296314,48,COMPLETED
5319815,1,1,1704296265,1704296266,1704296314,48,COMPLETED
5319816,1,1,1704296265,1704296266,1704296314,48,COMPLETED
5319817,1,1,1704296265,1704296266,1704296314,48,COMPLETED
5319818,1,1,1704296265,1704296266,1704296316,50,COMPLETED
5319819,1,1,1704296265,1704296266,1704296316,50,COMPLETED
5319820,1,1,1704296265,1704296266,1704296312,46,COMPLETED
5319821,1,1,1704296265,1704296266,1704296312,46,COMPLETED
5319822,1,1,1704296265,1704296266,1704296315,49,COMPLETED
5319823,1,1,1704296266,1704296266,1704296315,49,COMPLETED
5319824,1,1,1704296266,1704296266,1704296313,47,COMPLETED
5319825,1,1,1704296266,1704296266,1704296312,46,COMPLETED
5319826,1,1,1704296266,1704296266,1704296311,45,COMPLETED
5319827,1,1,1704296266,1704296266,1704296314,48,COMPLETED
5319828,1,1,1704296266,1704296266,1704296315,49,COMPLETED
5319829,1,1,1704296266,1704296266,1704296312,46,COMPLETED
5319830,1,1,1704296266,1704296270,1704296315,45,COMPLETED
5319831,1,1,1704296266,1704296270,1704296312,42,COMPLETED
5319832,1,1,1704296267,1704296270,1704296313,43,COMPLETED
5319833,1,1,1704296267,1704296270,1704296315,45,COMPLETED
5319834,1,1,1704296267,1704296270,1704296311,41,COMPLETED
5319835,1,1,1704296267,1704296270,1704296315,45,COMPLETED
5319836,1,1,1704296267,1704296270,1704296315,45,COMPLETED
5319837,1,1,1704296267,1704296270,1704296312,42,COMPLETED
5319838,1,1,1704296267,1704296270,1704296314,44,COMPLETED
5319839,1,1,1704296267,1704296270,1704296315,45,COMPLETED
5319840,1,1,1704296267,1704296270,1704296314,44,COMPLETED
5319841,1,1,1704296267,1704296270,1704296313,43,COMPLETED
5319842,1,1,1704296268,1704296270,1704296315,45,COMPLETED
5319843,1,1,1704296268,1704296270,1704296311,41,COMPLETED
5319844,1,1,1704296268,1704296270,1704296314,44,COMPLETED
5319845,1,1,1704296268,1704296270,1704296312,42,COMPLETED
5319846,1,1,1704296268,1704296270,1704296312,42,COMPLETED
5319847,1,1,1704296268,1704296270,1704296313,43,COMPLETED
5319848,1,1,1704296268,1704296270,1704296313,43,COMPLETED
5319849,1,1,1704296268,1704296270,1704296311,41,COMPLETED
5319850,1,1,1704296268,1704296270,1704296315,45,COMPLETED
5319851,1,1,1704296268,1704296270,1704296303,33,COMPLETED
5319852,1,1,1704296279,1704296280,1704296331,51,COMPLETED
5319853,1,1,1704296282,1704296282,1704296335,53,COMPLETED
5319854,1,1,1704296282,1704296282,1704296331,49,COMPLETED
5319855,1,1,1704296282,1704296282,1704296335,53,COMPLETED
5319856,1,1,1704296282,1704296282,1704296332,50,COMPLETED
5319857,1,1,1704296286,1704296288,1704296328,40,COMPLETED
5319858,1,1,1704296286,1704296288,1704296328,40,COMPLETED
5319859,1,1,1704296286,1704296288,1704296328,40,COMPLETED
5319860,1,1,1704296286,1704296288,1704296328,40,COMPLETED
5319861,1,1,1704296286,1704296288,1704296329,41,COMPLETED
5319862,1,1,1704296286,1704296288,1704296328,40,COMPLETED
5319863,1,1,1704296297,1704296297,1704296335,38,COMPLETED
5319864,1,1,1704296297,1704296301,1704296344,43,COMPLETED
5319865,1,1,1704296297,1704296301,1704296343,42,COMPLETED
5319866,1,1,1704296297,1704296301,1704296339,38,COMPLETED
5319867,1,1,1704296297,1704296301,1704296339,38,COMPLETED
5319868,1,1,1704296298,1704296301,1704296339,38,COMPLETED
5319869,1,1,1704296298,1704296301,1704296341,40,COMPLETED
5319870,1,1,1704296298,1704296301,1704296344,43,COMPLETED
5319871,1,1,1704296298,1704296301,1704296344,43,COMPLETED
5319872,1,1,1704296298,1704296301,1704296341,40,COMPLETED
5319873,1,1,1704296298,1704296301,1704296339,38,COMPLETED
5319874,1,1,1704296298,1704296301,1704296342,41,COMPLETED
5319875,1,1,1704296298,1704296301,1704296341,40,COMPLETED
5319876,1,1,1704296298,1704296301,1704296341,40,COMPLETED
5319877,1,1,1704296299,1704296301,1704296341,40,COMPLETED
5319878,1,1,1704296299,1704296301,1704296341,40,COMPLETED
5319879,1,1,1704296299,1704296301,1704296339,38,COMPLETED
5319880,1,1,1704296299,1704296301,1704296342,41,COMPLETED
5319881,1,1,1704296299,1704296301,1704296344,43,COMPLETED
5319882,1,1,1704296311,1704296311,1704296346,35,COMPLETED
5319883,1,1,1704296311,1704296311,1704296344,33,COMPLETED
5319884,1,1,1704296311,1704296312,1704296345,33,COMPLETED
5319885,1,1,1704296311,1704296312,1704296341,29,COMPLETED
5319886,1,1,1704296311,1704296312,1704296344,32,COMPLETED
5319887,1,1,1704296311,1704296312,1704296348,36,COMPLETED
5319888,1,1,1704296311,1704296312,1704296344,32,COMPLETED
5319889,1,1,1704296312,1704296312,1704296344,32,COMPLETED
5319890,1,1,1704296312,1704296312,1704296343,31,COMPLETED
5319891,1,1,1704296312,1704296312,1704296344,32,COMPLETED
5319892,1,1,1704296312,1704296312,1704296342,30,COMPLETED
5319893,1,1,1704296312,1704296312,1704296343,31,COMPLETED
5319894,1,1,1704296312,1704296312,1704296344,32,COMPLETED
5319895,1,1,1704296312,1704296312,1704296346,34,COMPLETED
5319896,1,1,1704296312,1704296312,1704296344,32,COMPLETED
5319897,1,1,1704296312,1704296312,1704296344,32,COMPLETED
5319898,1,1,1704296312,1704296312,1704296343,31,COMPLETED
5319899,1,1,1704296312,1704296312,1704296345,33,COMPLETED
5319900,1,1,1704296313,1704296313,1704296343,30,COMPLETED
5319901,1,1,1704296313,1704296313,1704296345,32,COMPLETED
5319902,1,1,1704296313,1704296313,1704296344,31,COMPLETED
5319903,1,1,1704296313,1704296313,1704296344,31,COMPLETED
5319904,1,1,1704296313,1704296313,1704296342,29,COMPLETED
5319905,1,1,1704296313,1704296313,1704296344,31,COMPLETED
5319906,1,1,1704296313,1704296313,1704296343,30,COMPLETED
5319907,1,1,1704296313,1704296313,1704296349,36,COMPLETED
5319908,1,1,1704296313,1704296313,1704296344,31,COMPLETED
5319909,1,1,1704296313,1704296313,1704296342,29,COMPLETED
5319910,1,1,1704296314,1704296314,1704296343,29,COMPLETED
5319911,1,1,1704296314,1704296314,1704296343,29,COMPLETED
5319912,1,1,1704296314,1704296314,1704296343,29,COMPLETED
5319913,1,1,1704296314,1704296314,1704296344,30,COMPLETED
5319914,1,1,1704296314,1704296314,1704296343,29,COMPLETED
5319915,1,1,1704296314,1704296314,1704296345,31,COMPLETED
5319916,1,1,1704296314,1704296314,1704296342,28,COMPLETED
5319917,1,1,1704296314,1704296314,1704296343,29,COMPLETED
5319918,1,1,1704296314,1704296314,1704296341,27,COMPLETED
5319919,1,1,1704296314,1704296314,1704296344,30,COMPLETED
5319920,1,1,1704296315,1704296315,1704296345,30,COMPLETED
5319921,1,1,1704296315,1704296315,1704296344,29,COMPLETED
5319922,1,1,1704296315,1704296315,1704296345,30,COMPLETED
5319923,1,1,1704296315,1704296315,1704296343,28,COMPLETED
5319924,1,1,1704296315,1704296315,1704296342,27,COMPLETED
5319925,1,1,1704296315,1704296315,1704296345,30,COMPLETED
5319926,1,1,1704296315,1704296315,1704296342,27,COMPLETED
5319927,1,1,1704296315,1704296315,1704296345,30,COMPLETED
5319928,1,1,1704296315,1704296315,1704296348,33,COMPLETED
5319929,1,1,1704296315,1704296315,1704296348,33,COMPLETED
5319930,1,1,1704296316,1704296316,1704296348,32,COMPLETED
5319931,1,1,1704296316,1704296316,1704296349,33,COMPLETED
5319932,1,1,1704296316,1704296316,1704296349,33,COMPLETED
5319933,1,1,1704296316,1704296316,1704296349,33,COMPLETED
5319934,1,1,1704296316,1704296316,1704296348,32,COMPLETED
5319935,1,1,1704296316,1704296316,1704296353,37,COMPLETED
5319936,1,1,1704296316,1704296316,1704296345,29,COMPLETED
5319937,1,1,1704296316,1704296316,1704296350,34,COMPLETED
5319938,1,1,1704296316,1704296316,1704296350,34,COMPLETED
5319939,1,1,1704296316,1704296316,1704296348,32,COMPLETED
5319940,1,1,1704296317,1704296317,1704296348,31,COMPLETED
5319941,1,1,1704296317,1704296317,1704296344,27,COMPLETED
5319942,1,1,1704296317,1704296317,1704296351,34,COMPLETED
5319943,1,1,1704296317,1704296317,1704296348,31,COMPLETED
5319944,1,1,1704296317,1704296317,1704296348,31,COMPLETED
5319945,1,1,1704296317,1704296317,1704296344,27,COMPLETED
5319946,1,1,1704296317,1704296317,1704296348,31,COMPLETED
5319947,1,1,1704296317,1704296317,1704296352,35,COMPLETED
5319948,1,1,1704296317,1704296317,1704296348,31,COMPLETED
5319949,1,1,1704296317,1704296319,1704296361,42,COMPLETED
5319950,1,1,1704296318,1704296319,1704296363,44,COMPLETED
5319951,1,1,1704296318,1704296319,1704296361,42,COMPLETED
5319952,1,1,1704296318,1704296319,1704296365,46,COMPLETED
5319953,1,1,1704296318,1704296319,1704296361,42,COMPLETED
5319954,1,1,1704296318,1704296319,1704296361,42,COMPLETED
5319955,1,1,1704296318,1704296319,1704296361,42,COMPLETED
5319956,1,1,1704296318,1704296319,1704296361,42,COMPLETED
5319957,1,1,1704296318,1704296319,1704296361,42,COMPLETED
5319958,1,1,1704296318,1704296319,1704296361,42,COMPLETED
5319959,1,1,1704296318,1704296319,1704296372,53,COMPLETED
5319960,1,1,1704296319,1704296319,1704296371,52,COMPLETED
5319961,1,1,1704296319,1704296319,1704296371,52,COMPLETED
5319962,1,1,1704296319,1704296319,1704296371,52,COMPLETED
5319963,1,1,1704296319,1704296319,1704296373,54,COMPLETED
5319964,1,1,1704296319,1704296319,1704296371,52,COMPLETED
5319965,1,1,1704296319,1704296319,1704296372,53,COMPLETED
5319966,1,1,1704296319,1704296319,1704296373,54,COMPLETED
5319967,1,1,1704296319,1704296319,1704296373,54,COMPLETED
5319968,1,1,1704296319,1704296319,1704296369,50,COMPLETED
5319969,1,1,1704296319,1704296319,1704296371,52,COMPLETED
5319970,1,1,1704296320,1704296323,1704296371,48,COMPLETED
5319971,1,1,1704296320,1704296323,1704296371,48,COMPLETED
5319972,1,1,1704296320,1704296323,1704296371,48,COMPLETED
5319973,1,1,1704296320,1704296323,1704296371,48,COMPLETED
5319974,1,1,1704296320,1704296323,1704296372,49,COMPLETED
5319975,1,1,1704296320,1704296323,1704296371,48,COMPLETED
5319976,1,1,1704296320,1704296323,1704296370,47,COMPLETED
5319977,1,1,1704296320,1704296323,1704296373,50,COMPLETED
5319978,1,1,1704296320,1704296323,1704296371,48,COMPLETED
5319979,1,1,1704296321,1704296323,1704296372,49,COMPLETED
5319980,1,1,1704296321,1704296323,1704296371,48,COMPLETED
5319981,1,1,1704296321,1704296323,1704296372,49,COMPLETED
5319982,1,1,1704296321,1704296323,1704296372,49,COMPLETED
5319983,1,1,1704296321,1704296323,1704296375,52,COMPLETED
5319984,1,1,1704296321,1704296323,1704296371,48,COMPLETED
5319985,1,1,1704296321,1704296323,1704296372,49,COMPLETED
5319986,1,1,1704296321,1704296323,1704296373,50,COMPLETED
5319987,1,1,1704296321,1704296323,1704296373,50,COMPLETED
5319988,1,1,1704296321,1704296323,1704296369,46,COMPLETED
5319989,1,1,1704296322,1704296323,1704296370,47,COMPLETED
5319990,1,1,1704296322,1704296323,1704296372,49,COMPLETED
5319991,1,1,1704296322,1704296323,1704296372,49,COMPLETED
5319992,1,1,1704296322,1704296323,1704296370,47,COMPLETED
5319993,1,1,1704296322,1704296323,1704296374,51,COMPLETED
5319994,1,1,1704296322,1704296323,1704296372,49,COMPLETED
5319995,1,1,1704296322,1704296323,1704296373,50,COMPLETED
5319996,1,1,1704296322,1704296323,1704296371,48,COMPLETED
5319997,1,1,1704296322,1704296323,1704296372,49,COMPLETED
5319998,1,1,1704296322,1704296323,1704296372,49,COMPLETED
5319999,1,1,1704296323,1704296323,1704296370,47,COMPLETED
5320000,1,1,1704296323,1704296323,1704296373,50,COMPLETED
5320001,1,1,1704296323,1704296323,1704296373,50,COMPLETED
5320002,1,1,1704296323,1704296323,1704296370,47,COMPLETED
5320003,1,1,1704296323,1704296323,1704296369,46,COMPLETED
5320004,1,1,1704296323,1704296323,1704296370,47,COMPLETED
5320005,1,1,1704296323,1704296323,1704296372,49,COMPLETED
5320006,1,1,1704296323,1704296323,1704296373,50,COMPLETED
5320007,1,1,1704296323,1704296323,1704296372,49,COMPLETED
5320008,1,1,1704296323,1704296327,1704296370,43,COMPLETED
5320009,1,1,1704296324,1704296327,1704296372,45,COMPLETED
5320010,1,1,1704296324,1704296327,1704296372,45,COMPLETED
5320011,1,1,1704296324,1704296327,1704296372,45,COMPLETED
5320012,1,1,1704296324,1704296327,1704296370,43,COMPLETED
5320013,1,1,1704296324,1704296327,1704296371,44,COMPLETED
5320014,1,1,1704296324,1704296327,1704296371,44,COMPLETED
5320015,1,1,1704296324,1704296327,1704296373,46,COMPLETED
5320016,1,1,1704296324,1704296327,1704296370,43,COMPLETED
5320017,1,1,1704296324,1704296327,1704296371,44,COMPLETED
5320018,1,1,1704296324,1704296327,1704296372,45,COMPLETED
5320019,1,1,1704296325,1704296327,1704296369,42,COMPLETED
5320020,1,1,1704296325,1704296327,1704296373,46,COMPLETED
5320021,1,1,1704296325,1704296327,1704296372,45,COMPLETED
5320022,1,1,1704296325,1704296327,1704296372,45,COMPLETED
5320023,1,1,1704296325,1704296327,1704296371,44,COMPLETED
5320024,1,1,1704296325,1704296327,1704296372,45,COMPLETED
5320025,1,1,1704296325,1704296327,1704296370,43,COMPLETED
5320026,1,1,1704296325,1704296327,1704296370,43,COMPLETED
5320027,1,1,1704296325,1704296327,1704296370,43,COMPLETED
5320028,1,1,1704296325,1704296327,1704296370,43,COMPLETED
5320029,1,1,1704296326,1704296327,1704296371,44,COMPLETED
5320030,1,1,1704296326,1704296327,1704296372,45,COMPLETED
5320031,1,1,1704296326,1704296327,1704296368,41,COMPLETED
5320032,1,1,1704296326,1704296327,1704296366,39,COMPLETED
5320033,1,1,1704296326,1704296327,1704296365,38,COMPLETED
5320034,1,1,1704296326,1704296327,1704296366,39,COMPLETED
5320035,1,1,1704296326,1704296327,1704296365,38,COMPLETED
5320036,1,1,1704296326,1704296327,1704296368,41,COMPLETED
5320037,1,1,1704296326,1704296327,1704296366,39,COMPLETED
5320038,1,1,1704296326,1704296327,1704296367,40,COMPLETED
5320039,1,1,1704296327,1704296327,1704296367,40,COMPLETED
5320040,1,1,1704296327,1704296327,1704296367,40,COMPLETED
5320041,1,1,1704296327,1704296327,1704296366,39,COMPLETED
5320042,1,1,1704296327,1704296327,1704296368,41,COMPLETED
5320043,1,1,1704296327,1704296327,1704296367,40,COMPLETED
5320044,1,1,1704296327,1704296327,1704296367,40,COMPLETED
5320045,1,1,1704296327,1704296327,1704296367,40,COMPLETED
5320046,1,1,1704296327,1704296327,1704296367,40,COMPLETED
5320047,1,1,1704296327,1704296327,1704296364,37,COMPLETED
5320048,1,1,1704296327,1704296327,1704296367,40,COMPLETED
5320049,1,1,1704296328,1704296329,1704296366,37,COMPLETED
5320050,1,1,1704296328,1704296329,1704296367,38,COMPLETED
5320051,1,1,1704296354,1704296354,1704296396,42,COMPLETED
5320052,1,1,1704296354,1704296354,1704296396,42,COMPLETED
5320053,1,1,1704296355,1704296358,1704296398,40,COMPLETED
5320054,1,1,1704296355,1704296358,1704296398,40,COMPLETED
5320055,1,1,1704296355,1704296358,1704296396,38,COMPLETED
5320056,1,1,1704296355,1704296358,1704296396,38,COMPLETED
5320057,1,1,1704296355,1704296358,1704296399,41,COMPLETED
5320058,1,1,1704296355,1704296358,1704296397,39,COMPLETED
5320059,1,1,1704296355,1704296358,1704296397,39,COMPLETED
5320060,1,1,1704296355,1704296358,1704296399,41,COMPLETED
5320061,1,1,1704296355,1704296358,1704296396,38,COMPLETED
5320062,1,1,1704296355,1704296358,1704296397,39,COMPLETED
5320063,1,1,1704296356,1704296358,1704296396,38,COMPLETED
5320064,1,1,1704296356,1704296358,1704296397,39,COMPLETED
5320065,1,1,1704296356,1704296358,1704296398,40,COMPLETED
5320066,1,1,1704296356,1704296358,1704296398,40,COMPLETED
5320067,1,1,1704296356,1704296358,1704296401,43,COMPLETED
5320068,1,1,1704296356,1704296358,1704296396,38,COMPLETED
5320069,1,1,1704296356,1704296358,1704296401,43,COMPLETED
5320070,1,1,1704296356,1704296358,1704296398,40,COMPLETED
5320071,1,1,1704296356,1704296358,1704296397,39,COMPLETED
5320072,1,1,1704296356,1704296358,1704296396,38,COMPLETED
5320073,1,1,1704296357,1704296358,1704296396,38,COMPLETED
5320074,1,1,1704296357,1704296358,1704296397,39,COMPLETED
5320075,1,1,1704296357,1704296358,1704296397,39,COMPLETED
5320076,1,1,1704296357,1704296358,1704296397,39,COMPLETED
5320077,1,1,1704296357,1704296358,1704296399,41,COMPLETED
5320078,1,1,1704296357,1704296358,1704296399,41,COMPLETED
5320079,1,1,1704296357,1704296358,1704296399,41,COMPLETED
5320080,1,1,1704296357,1704296358,1704296397,39,COMPLETED
5320081,1,1,1704296369,1704296369,1704296396,27,COMPLETED
5320082,1,1,1704296369,1704296369,1704296397,28,COMPLETED
5320083,1,1,1704296369,1704296369,1704296396,27,COMPLETED
5320084,1,1,1704296369,1704296369,1704296398,29,COMPLETED
5320085,1,1,1704296369,1704296369,1704296397,28,COMPLETED
5320086,1,1,1704296369,1704296369,1704296398,29,COMPLETED
5320087,1,1,1704296369,1704296370,1704296397,27,COMPLETED
5320088,1,1,1704296369,1704296370,1704296395,25,COMPLETED
5320089,1,1,1704296370,1704296371,1704296396,25,COMPLETED
5320090,1,1,1704296370,1704296371,1704296396,25,COMPLETED
5320091,1,1,1704296370,1704296371,1704296397,26,COMPLETED
5320092,1,1,1704296370,1704296371,1704296396,25,COMPLETED
5320093,1,1,1704296370,1704296371,1704296395,24,COMPLETED
5320094,1,1,1704296370,1704296371,1704296397,26,COMPLETED
5320095,1,1,1704296370,1704296371,1704296395,24,COMPLETED
5320096,1,1,1704296370,1704296371,1704296395,24,COMPLETED
5320097,1,1,1704296370,1704296371,1704296396,25,COMPLETED
5320098,1,1,1704296370,1704296371,1704296395,24,COMPLETED
5320099,1,1,1704296371,1704296371,1704296395,24,COMPLETED
5320100,1,1,1704296371,1704296371,1704296397,26,COMPLETED
5320101,1,1,1704296371,1704296371,1704296396,25,COMPLETED
5320102,1,1,1704296371,1704296371,1704296397,26,COMPLETED
5320103,1,1,1704296371,1704296371,1704296397,26,COMPLETED
5320104,1,1,1704296371,1704296371,1704296395,24,COMPLETED
5320105,1,1,1704296371,1704296371,1704296396,25,COMPLETED
5320106,1,1,1704296371,1704296371,1704296395,24,COMPLETED
5320107,1,1,1704296371,1704296371,1704296395,24,COMPLETED
5320108,1,1,1704296371,1704296371,1704296396,25,COMPLETED
5320109,1,1,1704296372,1704296372,1704296395,23,COMPLETED
5320110,1,1,1704296372,1704296372,1704296396,24,COMPLETED
5320111,1,1,1704296372,1704296372,1704296396,24,COMPLETED
5320112,1,1,1704296372,1704296372,1704296396,24,COMPLETED
5320113,1,1,1704296372,1704296372,1704296395,23,COMPLETED
5320115,1,1,1704296490,1704296491,1704296542,51,COMPLETED
5320116,1,1,1704296490,1704296491,1704296539,48,COMPLETED
5320117,1,1,1704296490,1704296491,1704296546,55,COMPLETED
5320118,1,1,1704296490,1704296491,1704296538,47,COMPLETED
5320119,1,1,1704296491,1704296491,1704296538,47,COMPLETED
5320120,1,1,1704296491,1704296495,1704296539,44,COMPLETED
5320121,1,1,1704296491,1704296495,1704296544,49,COMPLETED
5320122,1,1,1704296491,1704296495,1704296538,43,COMPLETED
5320123,1,1,1704296491,1704296495,1704296538,43,COMPLETED
5320124,1,1,1704296491,1704296495,1704296540,45,COMPLETED
5320125,1,1,1704296491,1704296495,1704296541,46,COMPLETED
5320126,1,1,1704296491,1704296495,1704296538,43,COMPLETED
5320127,1,1,1704296491,1704296495,1704296538,43,COMPLETED
5320128,1,1,1704296491,1704296495,1704296539,44,COMPLETED
5320129,1,1,1704296491,1704296495,1704296538,43,COMPLETED
5320130,1,1,1704296491,1704296495,1704296545,50,COMPLETED
5320131,1,1,1704296491,1704296495,1704296538,43,COMPLETED
5320132,1,1,1704296491,1704296495,1704296540,45,COMPLETED
5320133,1,1,1704296491,1704296495,1704296543,48,COMPLETED
5320134,1,1,1704296491,1704296495,1704296538,43,COMPLETED
5320135,1,1,1704296491,1704296495,1704296539,44,COMPLETED
5320136,1,1,1704296491,1704296495,1704296545,50,COMPLETED
5320137,1,1,1704296491,1704296495,1704296541,46,COMPLETED
5320138,1,1,1704296491,1704296495,1704296542,47,COMPLETED
5320139,1,1,1704296491,1704296495,1704296541,46,COMPLETED
5320140,1,1,1704296491,1704296495,1704296538,43,COMPLETED
5320141,1,1,1704296491,1704296495,1704296538,43,COMPLETED
5320142,1,1,1704296491,1704296495,1704296539,44,COMPLETED
5320143,1,1,1704296491,1704296495,1704296538,43,COMPLETED
5320144,1,1,1704296491,1704296495,1704296538,43,COMPLETED
5320145,1,1,1704296491,1704296495,1704296538,43,COMPLETED
5320146,1,1,1704296491,1704296495,1704296542,47,COMPLETED
5320147,1,1,1704296491,1704296495,1704296541,46,COMPLETED
5320148,1,1,1704296491,1704296495,1704296538,43,COMPLETED
5320149,1,1,1704296491,1704296495,1704296541,46,COMPLETED
5320150,1,1,1704296491,1704296495,1704296538,43,COMPLETED
5320151,1,1,1704296491,1704296495,1704296538,43,COMPLETED
5320152,1,1,1704296492,1704296495,1704296538,43,COMPLETED
5320153,1,1,1704296492,1704296495,1704296538,43,COMPLETED
5320154,1,1,1704296492,1704296495,1704296538,43,COMPLETED
5320155,1,1,1704296492,1704296495,1704296538,43,COMPLETED
5320156,1,1,1704296492,1704296495,1704296538,43,COMPLETED
5320157,1,1,1704296492,1704296495,1704296541,46,COMPLETED
5320158,1,1,1704296492,1704296495,1704296539,44,COMPLETED
5320159,1,1,1704296492,1704296495,1704296538,43,COMPLETED
5320160,1,1,1704296492,1704296495,1704296546,51,COMPLETED
5320161,1,1,1704296492,1704296495,1704296544,49,COMPLETED
5320162,1,1,1704296492,1704296495,1704296538,43,COMPLETED
5320163,1,1,1704296492,1704296495,1704296538,43,COMPLETED
5320164,1,1,1704296492,1704296495,1704296538,43,COMPLETED
5320165,1,1,1704296492,1704296495,1704296538,43,COMPLETED
5320166,1,1,1704296492,1704296495,1704296538,43,COMPLETED
5320167,1,1,1704296492,1704296495,1704296538,43,COMPLETED
5320168,1,1,1704296492,1704296495,1704296538,43,COMPLETED
5320169,1,1,1704296492,1704296495,1704296538,43,COMPLETED
5320170,1,1,1704296492,1704296495,1704296538,43,COMPLETED
5320171,1,1,1704296492,1704296495,1704296546,51,COMPLETED
5320172,1,1,1704296492,1704296495,1704296540,45,COMPLETED
5320173,1,1,1704296492,1704296495,1704296540,45,COMPLETED
5320174,1,1,1704296492,1704296495,1704296539,44,COMPLETED
5320175,1,1,1704296492,1704296495,1704296538,43,COMPLETED
5320176,1,1,1704296492,1704296495,1704296545,50,COMPLETED
5320177,1,1,1704296492,1704296495,1704296538,43,COMPLETED
5320178,1,1,1704296492,1704296495,1704296538,43,COMPLETED
5320179,1,1,1704296492,1704296495,1704296545,50,COMPLETED
5320180,1,1,1704296492,1704296495,1704296541,46,COMPLETED
5320181,1,1,1704296492,1704296495,1704296538,43,COMPLETED
5320182,1,1,1704296492,1704296495,1704296541,46,COMPLETED
5320183,1,1,1704296492,1704296495,1704296538,43,COMPLETED
5320184,1,1,1704296492,1704296495,1704296544,49,COMPLETED
5320185,1,1,1704296492,1704296495,1704296538,43,COMPLETED
5320186,1,1,1704296492,1704296495,1704296538,43,COMPLETED
5320187,1,1,1704296493,1704296495,1704296540,45,COMPLETED
5320188,1,1,1704296493,1704296495,1704296541,46,COMPLETED
5320189,1,1,1704296493,1704296495,1704296538,43,COMPLETED
5320190,1,1,1704296493,1704296495,1704296538,43,COMPLETED
5320191,1,1,1704296493,1704296495,1704296538,43,COMPLETED
5320192,1,1,1704296493,1704296495,1704296538,43,COMPLETED
5320193,1,1,1704296493,1704296495,1704296538,43,COMPLETED
5320194,1,1,1704296493,1704296495,1704296538,43,COMPLETED
5320195,1,1,1704296493,1704296495,1704296538,43,COMPLETED
5320196,1,1,1704296493,1704296495,1704296540,45,COMPLETED
5320197,1,1,1704296493,1704296495,1704296539,44,COMPLETED
5320198,1,1,1704296493,1704296495,1704296538,43,COMPLETED
5320199,1,1,1704296493,1704296495,1704296538,43,COMPLETED
5320200,1,1,1704296493,1704296495,1704296538,43,COMPLETED
5320201,1,1,1704296493,1704296495,1704296539,44,COMPLETED
5320202,1,1,1704296493,1704296495,1704296540,45,COMPLETED
5320203,1,1,1704296493,1704296495,1704296538,43,COMPLETED
5320204,1,1,1704296493,1704296495,1704296538,43,COMPLETED
5320205,1,1,1704296493,1704296495,1704296547,52,COMPLETED
5320206,1,1,1704296493,1704296495,1704296538,43,COMPLETED
5320207,1,1,1704296493,1704296495,1704296538,43,COMPLETED
5320208,1,1,1704296493,1704296495,1704296538,43,COMPLETED
5320209,1,1,1704296493,1704296495,1704296538,43,COMPLETED
5320210,1,1,1704296494,1704296495,1704296544,49,COMPLETED
5320211,1,1,1704296494,1704296495,1704296538,43,COMPLETED
5320212,1,1,1704296494,1704296495,1704296539,44,COMPLETED
5320213,1,1,1704296494,1704296495,1704296542,47,COMPLETED
5320214,1,1,1704296494,1704296495,1704296538,43,COMPLETED
5320215,1,1,1704296494,1704296495,1704296544,49,COMPLETED
5320216,1,1,1704296494,1704296495,1704296541,46,COMPLETED
5320217,1,1,1704296494,1704296495,1704296539,44,COMPLETED
5320218,1,1,1704296494,1704296495,1704296542,47,COMPLETED
5320219,1,1,1704296494,1704296495,1704296538,43,COMPLETED
5320220,1,1,1704296494,1704296495,1704296539,44,COMPLETED
5320221,1,1,1704296494,1704296495,1704296539,44,COMPLETED
5320222,1,1,1704296494,1704296495,1704296538,43,COMPLETED
5320223,1,1,1704296494,1704296495,1704296542,47,COMPLETED
5320224,1,1,1704296494,1704296495,1704296538,43,COMPLETED
5320225,1,1,1704296494,1704296495,1704296538,43,COMPLETED
5320226,1,1,1704296494,1704296495,1704296538,43,COMPLETED
5320227,1,1,1704296494,1704296495,1704296538,43,COMPLETED
5320228,1,1,1704296494,1704296495,1704296538,43,COMPLETED
5320229,1,1,1704296494,1704296495,1704296538,43,COMPLETED
5320230,1,1,1704296494,1704296495,1704296538,43,COMPLETED
5320231,1,1,1704296494,1704296495,1704296538,43,COMPLETED
5320232,1,1,1704296494,1704296495,1704296540,45,COMPLETED
5320233,1,1,1704296494,1704296495,1704296538,43,COMPLETED
5320234,1,1,1704296494,1704296495,1704296539,44,COMPLETED
5320235,1,1,1704296494,1704296495,1704296541,46,COMPLETED
5320236,1,1,1704296494,1704296495,1704296538,43,COMPLETED
5320237,1,1,1704296494,1704296495,1704296546,51,COMPLETED
5320238,1,1,1704296494,1704296495,1704296538,43,COMPLETED
5320239,1,1,1704296494,1704296495,1704296538,43,COMPLETED
5320240,1,1,1704296494,1704296495,1704296538,43,COMPLETED
5320241,1,1,1704296494,1704296495,1704296538,43,COMPLETED
5320242,1,1,1704296494,1704296495,1704296538,43,COMPLETED
5320243,1,1,1704296494,1704296495,1704296544,49,COMPLETED
5320244,1,1,1704296494,1704296495,1704296538,43,COMPLETED
5320245,1,1,1704296494,1704296495,1704296538,43,COMPLETED
5320246,1,1,1704296494,1704296495,1704296538,43,COMPLETED
5320247,1,1,1704296494,1704296495,1704296540,45,COMPLETED
5320248,1,1,1704296495,1704296499,1704296542,43,COMPLETED
5320249,1,1,1704296495,1704296499,1704296538,39,COMPLETED
5320250,1,1,1704296495,1704296499,1704296538,39,COMPLETED
5320251,1,1,1704296495,1704296499,1704296541,42,COMPLETED
5320252,1,1,1704296495,1704296499,1704296538,39,COMPLETED
5320253,1,1,1704296495,1704296499,1704296539,40,COMPLETED
5320254,1,1,1704296496,1704296499,1704296538,39,COMPLETED
5320255,1,1,1704296496,1704296499,1704296538,39,COMPLETED
5320256,1,1,1704296496,1704296499,1704296541,42,COMPLETED
5320257,1,1,1704296496,1704296499,1704296540,41,COMPLETED
5320258,1,1,1704296496,1704296499,1704296538,39,COMPLETED
5320259,1,1,1704296496,1704296499,1704296540,41,COMPLETED
5320260,1,1,1704296496,1704296499,1704296539,40,COMPLETED
5320261,1,1,1704296496,1704296499,1704296544,45,COMPLETED
5320262,1,1,1704296496,1704296499,1704296538,39,COMPLETED
5320263,1,1,1704296496,1704296499,1704296540,41,COMPLETED
5320264,1,1,1704296496,1704296499,1704296539,40,COMPLETED
5320265,1,1,1704296496,1704296499,1704296538,39,COMPLETED
5320266,1,1,1704296496,1704296499,1704296538,39,COMPLETED
5320267,1,1,1704296496,1704296499,1704296538,39,COMPLETED
5320268,1,1,1704296496,1704296499,1704296538,39,COMPLETED
5320269,1,1,1704296496,1704296499,1704296538,39,COMPLETED
5320270,1,1,1704296496,1704296499,1704296538,39,COMPLETED
5320271,1,1,1704296496,1704296499,1704296545,46,COMPLETED
5320272,1,1,1704296496,1704296499,1704296539,40,COMPLETED
5320273,1,1,1704296496,1704296499,1704296538,39,COMPLETED
5320274,1,1,1704296496,1704296499,1704296538,39,COMPLETED
5320275,1,1,1704296496,1704296499,1704296543,44,COMPLETED
5320276,1,1,1704296496,1704296499,1704296539,40,COMPLETED
5320277,1,1,1704296496,1704296499,1704296539,40,COMPLETED
5320278,1,1,1704296496,1704296499,1704296538,39,COMPLETED
5320279,1,1,1704296497,1704296499,1704296540,41,COMPLETED
5320280,1,1,1704296497,1704296499,1704296538,39,COMPLETED
5320281,1,1,1704296497,1704296499,1704296538,39,COMPLETED
5320282,1,1,1704296497,1704296499,1704296539,40,COMPLETED
5320283,1,1,1704296497,1704296499,1704296538,39,COMPLETED
5320284,1,1,1704296497,1704296499,1704296538,39,COMPLETED
5320285,1,1,1704296497,1704296499,1704296539,40,COMPLETED
5320286,1,1,1704296497,1704296499,1704296538,39,COMPLETED
5320287,1,1,1704296497,1704296499,1704296538,39,COMPLETED
5320288,1,1,1704296497,1704296499,1704296538,39,COMPLETED
5320289,1,1,1704296497,1704296499,1704296540,41,COMPLETED
5320290,1,1,1704296497,1704296499,1704296539,40,COMPLETED
5320291,1,1,1704296497,1704296499,1704296538,39,COMPLETED
5320292,1,1,1704296497,1704296499,1704296538,39,COMPLETED
5320293,1,1,1704296497,1704296499,1704296538,39,COMPLETED
5320294,1,1,1704296497,1704296499,1704296538,39,COMPLETED
5320295,1,1,1704296497,1704296499,1704296538,39,COMPLETED
5320296,1,1,1704296497,1704296499,1704296538,39,COMPLETED
5320297,1,1,1704296497,1704296499,1704296538,39,COMPLETED
5320298,1,1,1704296497,1704296499,1704296538,39,COMPLETED
5320299,1,1,1704296497,1704296499,1704296538,39,COMPLETED
5320300,1,1,1704296497,1704296499,1704296539,40,COMPLETED
5320301,1,1,1704296497,1704296499,1704296538,39,COMPLETED
5320302,1,1,1704296497,1704296499,1704296538,39,COMPLETED
5320303,1,1,1704296497,1704296499,1704296538,39,COMPLETED
5320304,1,1,1704296497,1704296499,1704296538,39,COMPLETED
5320305,1,1,1704296497,1704296499,1704296538,39,COMPLETED
5320306,1,1,1704296497,1704296499,1704296538,39,COMPLETED
5320307,1,1,1704296497,1704296499,1704296538,39,COMPLETED
5320308,1,1,1704296497,1704296499,1704296538,39,COMPLETED
5320309,1,1,1704296497,1704296499,1704296538,39,COMPLETED
5320310,1,1,1704296497,1704296499,1704296538,39,COMPLETED
5320311,1,1,1704296497,1704296499,1704296538,39,COMPLETED
5320312,1,1,1704296497,1704296499,1704296538,39,COMPLETED
5320313,1,1,1704296497,1704296499,1704296546,47,COMPLETED
5320314,1,1,1704296497,1704296499,1704296538,39,COMPLETED
5320315,1,1,1704296539,1704296539,1704296567,28,COMPLETED
5320316,1,1,1704296539,1704296539,1704296567,28,COMPLETED
5320317,1,1,1704296539,1704296539,1704296566,27,COMPLETED
5320318,1,1,1704296539,1704296539,1704296567,28,COMPLETED
5320319,1,1,1704296539,1704296539,1704296567,28,COMPLETED
5320320,1,1,1704296539,1704296539,1704296567,28,COMPLETED
5320321,1,1,1704296539,1704296539,1704296567,28,COMPLETED
5320322,1,1,1704296540,1704296540,1704296568,28,COMPLETED
5320323,1,1,1704296540,1704296540,1704296567,27,COMPLETED
5320324,1,1,1704296540,1704296540,1704296566,26,COMPLETED
5320325,1,1,1704296540,1704296540,1704296567,27,COMPLETED
5320326,1,1,1704296540,1704296540,1704296571,31,COMPLETED
5320327,1,1,1704296540,1704296540,1704296567,27,COMPLETED
5320328,1,1,1704296540,1704296540,1704296567,27,COMPLETED
5320329,1,1,1704296541,1704296541,1704296567,26,COMPLETED
5320330,1,1,1704296541,1704296541,1704296565,24,COMPLETED
5320331,1,1,1704296541,1704296541,1704296565,24,COMPLETED
5320332,1,1,1704296541,1704296541,1704296565,24,COMPLETED
5320333,1,1,1704296541,1704296541,1704296565,24,COMPLETED
5320334,1,1,1704296541,1704296541,1704296565,24,COMPLETED
5320335,1,1,1704296541,1704296541,1704296566,25,COMPLETED
5320336,1,1,1704296542,1704296542,1704296565,23,COMPLETED
5320337,1,1,1704296542,1704296542,1704296566,24,COMPLETED
5320338,1,1,1704296542,1704296542,1704296565,23,COMPLETED
5320339,1,1,1704296542,1704296542,1704296566,24,COMPLETED
5320340,1,1,1704296542,1704296542,1704296565,23,COMPLETED
5320341,1,1,1704296542,1704296542,1704296566,24,COMPLETED
5320342,1,1,1704296542,1704296542,1704296565,23,COMPLETED
5320343,1,1,1704296542,1704296542,1704296565,23,COMPLETED
5320344,1,1,1704296542,1704296542,1704296565,23,COMPLETED
5320345,1,1,1704296542,1704296542,1704296565,23,COMPLETED
5320346,360,10,1704296548,1704296550,1704468656,172106,FAILED
5320347,1,1,1704296554,1704296555,1704296579,24,COMPLETED
5320348,1,1,1704296554,1704296555,1704296579,24,COMPLETED
5320349,1,1,1704296554,1704296555,1704296579,24,COMPLETED
5320350,1,1,1704296554,1704296555,1704296579,24,COMPLETED
5320351,1,1,1704296555,1704296559,1704296597,38,COMPLETED
5320352,1,1,1704296555,1704296559,1704296599,40,COMPLETED
5320353,1,1,1704296555,1704296559,1704296598,39,COMPLETED
5320354,1,1,1704296555,1704296559,1704296598,39,COMPLETED
5320355,1,1,1704296555,1704296559,1704296599,40,COMPLETED
5320356,1,1,1704296555,1704296559,1704296599,40,COMPLETED
5320357,1,1,1704296555,1704296559,1704296599,40,COMPLETED
5320358,1,1,1704296555,1704296559,1704296597,38,COMPLETED
5320359,1,1,1704296555,1704296559,1704296599,40,COMPLETED
5320360,1,1,1704296555,1704296559,1704296599,40,COMPLETED
5320361,1,1,1704296556,1704296559,1704296600,41,COMPLETED
5320362,1,1,1704296556,1704296559,1704296598,39,COMPLETED
5320363,1,1,1704296556,1704296559,1704296597,38,COMPLETED
5320364,1,1,1704296556,1704296559,1704296597,38,COMPLETED
5320365,1,1,1704296556,1704296559,1704296598,39,COMPLETED
5320366,1,1,1704296556,1704296559,1704296601,42,COMPLETED
5320367,1,1,1704296556,1704296559,1704296598,39,COMPLETED
5320368,1,1,1704296556,1704296559,1704296599,40,COMPLETED
5320369,1,1,1704296556,1704296559,1704296597,38,COMPLETED
5320370,1,1,1704296557,1704296559,1704296600,41,COMPLETED
5320371,1,1,1704296557,1704296559,1704296597,38,COMPLETED
5320372,1,1,1704296557,1704296559,1704296600,41,COMPLETED
5320373,1,1,1704296557,1704296559,1704296598,39,COMPLETED
5320374,1,1,1704296557,1704296559,1704296597,38,COMPLETED
5320375,1,1,1704296557,1704296559,1704296598,39,COMPLETED
5320376,1,1,1704296557,1704296559,1704296597,38,COMPLETED
5320377,1,1,1704296557,1704296559,1704296600,41,COMPLETED
5320378,1,1,1704296557,1704296559,1704296598,39,COMPLETED
5320379,1,1,1704296557,1704296559,1704296600,41,COMPLETED
5320380,1,1,1704296557,1704296559,1704296600,41,COMPLETED
5320381,1,1,1704296558,1704296559,1704296600,41,COMPLETED
5320382,1,1,1704296558,1704296559,1704296599,40,COMPLETED
5320383,1,1,1704296558,1704296559,1704296596,37,COMPLETED
5320384,1,1,1704296558,1704296559,1704296596,37,COMPLETED
5320385,1,1,1704296558,1704296559,1704296599,40,COMPLETED
5320386,1,1,1704296558,1704296559,1704296598,39,COMPLETED
5320387,1,1,1704296558,1704296559,1704296597,38,COMPLETED
5320388,1,1,1704296558,1704296559,1704296596,37,COMPLETED
5320389,1,1,1704296558,1704296559,1704296596,37,COMPLETED
5320390,1,1,1704296558,1704296559,1704296597,38,COMPLETED
5320391,1,1,1704296559,1704296563,1704296597,34,COMPLETED
5320392,1,1,1704296559,1704296563,1704296598,35,COMPLETED
5320393,1,1,1704296559,1704296563,1704296595,32,COMPLETED
5320394,1,1,1704296559,1704296563,1704296598,35,COMPLETED
5320395,1,1,1704296559,1704296563,1704296596,33,COMPLETED
5320396,1,1,1704296559,1704296563,1704296598,35,COMPLETED
5320397,1,1,1704296560,1704296563,1704296597,34,COMPLETED
5320398,1,1,1704296560,1704296563,1704296598,35,COMPLETED
5320399,1,1,1704296560,1704296563,1704296597,34,COMPLETED
5320400,1,1,1704296560,1704296563,1704296597,34,COMPLETED
5320401,1,1,1704296560,1704296563,1704296595,32,COMPLETED
5320402,1,1,1704296560,1704296563,1704296597,34,COMPLETED
5320403,1,1,1704296560,1704296563,1704296596,33,COMPLETED
5320404,1,1,1704296560,1704296563,1704296596,33,COMPLETED
5320405,1,1,1704296560,1704296563,1704296598,35,COMPLETED
5320406,1,1,1704296560,1704296563,1704296595,32,COMPLETED
5320407,1,1,1704296560,1704296563,1704296596,33,COMPLETED
5320408,1,1,1704296560,1704296563,1704296598,35,COMPLETED
5320409,1,1,1704296560,1704296563,1704296595,32,COMPLETED
5320410,1,1,1704296561,1704296563,1704296599,36,COMPLETED
5320411,1,1,1704296561,1704296563,1704296595,32,COMPLETED
5320412,1,1,1704296561,1704296563,1704296595,32,COMPLETED
5320413,1,1,1704296561,1704296563,1704296595,32,COMPLETED
5320414,1,1,1704296561,1704296563,1704296597,34,COMPLETED
5320415,1,1,1704296561,1704296563,1704296595,32,COMPLETED
5320416,1,1,1704296561,1704296563,1704296595,32,COMPLETED
5320417,1,1,1704296561,1704296563,1704296595,32,COMPLETED
5320418,1,1,1704296561,1704296563,1704296595,32,COMPLETED
5320419,1,1,1704296561,1704296563,1704296595,32,COMPLETED
5320420,1,1,1704296561,1704296563,1704296595,32,COMPLETED
5320421,1,1,1704296562,1704296563,1704296600,37,COMPLETED
5320422,1,1,1704296562,1704296563,1704296595,32,COMPLETED
5320423,1,1,1704296562,1704296563,1704296595,32,COMPLETED
5320424,1,1,1704296562,1704296563,1704296595,32,COMPLETED
5320425,1,1,1704296562,1704296563,1704296595,32,COMPLETED
5320426,1,1,1704296562,1704296563,1704296595,32,COMPLETED
5320427,1,1,1704296562,1704296563,1704296595,32,COMPLETED
5320428,1,1,1704296562,1704296563,1704296595,32,COMPLETED
5320429,1,1,1704296562,1704296563,1704296595,32,COMPLETED
5320430,1,1,1704296562,1704296563,1704296595,32,COMPLETED
5320431,1,1,1704296563,1704296566,1704296603,37,COMPLETED
5320432,1,1,1704296563,1704296566,1704296605,39,COMPLETED
5320433,1,1,1704296563,1704296566,1704296606,40,COMPLETED
5320434,1,1,1704296563,1704296566,1704296605,39,COMPLETED
5320435,1,1,1704296563,1704296566,1704296607,41,COMPLETED
5320436,1,1,1704296564,1704296566,1704296605,39,COMPLETED
5320437,1,1,1704296564,1704296566,1704296606,40,COMPLETED
5320438,1,1,1704296564,1704296566,1704296606,40,COMPLETED
5320439,1,1,1704296564,1704296566,1704296605,39,COMPLETED
5320440,1,1,1704296564,1704296566,1704296606,40,COMPLETED
5320441,1,1,1704296564,1704296566,1704296603,37,COMPLETED
5320442,1,1,1704296564,1704296566,1704296603,37,COMPLETED
5320443,1,1,1704296564,1704296566,1704296605,39,COMPLETED
5320444,1,1,1704296564,1704296566,1704296601,35,COMPLETED
5320445,1,1,1704296564,1704296566,1704296605,39,COMPLETED
5320446,1,1,1704296564,1704296566,1704296605,39,COMPLETED
5320447,1,1,1704296564,1704296566,1704296605,39,COMPLETED
5320448,1,1,1704296564,1704296566,1704296601,35,COMPLETED
5320449,1,1,1704296564,1704296566,1704296609,43,COMPLETED
5320450,1,1,1704296564,1704296566,1704296609,43,COMPLETED
5320451,1,1,1704296565,1704296566,1704296606,40,COMPLETED
5320452,1,1,1704296565,1704296566,1704296608,42,COMPLETED
5320453,1,1,1704296565,1704296566,1704296606,40,COMPLETED
5320454,1,1,1704296565,1704296566,1704296603,37,COMPLETED
5320455,1,1,1704296565,1704296566,1704296606,40,COMPLETED
5320456,1,1,1704296565,1704296566,1704296609,43,COMPLETED
5320457,1,1,1704296565,1704296566,1704296603,37,COMPLETED
5320458,1,1,1704296565,1704296566,1704296603,37,COMPLETED
5320459,1,1,1704296565,1704296566,1704296609,43,COMPLETED
5320460,1,1,1704296565,1704296566,1704296783,217,COMPLETED
5320462,1,1,1704296566,1704296566,1704296604,38,COMPLETED
5320463,1,1,1704296566,1704296566,1704296603,37,COMPLETED
5320464,1,1,1704296566,1704296566,1704296610,44,COMPLETED
5320465,1,1,1704296566,1704296566,1704296603,37,COMPLETED
5320466,1,1,1704296566,1704296566,1704296603,37,COMPLETED
5320467,1,1,1704296566,1704296566,1704296603,37,COMPLETED
5320468,1,1,1704296566,1704296566,1704296597,31,COMPLETED
5320469,1,1,1704296566,1704296566,1704296596,30,COMPLETED
5320470,1,1,1704296566,1704296566,1704296597,31,COMPLETED
5320471,1,1,1704296566,1704296566,1704296596,30,COMPLETED
5320461,36,1,1704296566,1704296566,1704296653,87,TIMEOUT
5320472,1,1,1704296567,1704296567,1704296595,28,COMPLETED
5320473,1,1,1704296567,1704296567,1704296596,29,COMPLETED
5320474,1,1,1704296567,1704296567,1704296596,29,COMPLETED
5320475,1,1,1704296567,1704296567,1704296595,28,COMPLETED
5320476,1,1,1704296567,1704296567,1704296595,28,COMPLETED
5320477,1,1,1704296567,1704296567,1704296595,28,COMPLETED
5320478,1,1,1704296567,1704296567,1704296596,29,COMPLETED
5320479,1,1,1704296567,1704296568,1704296595,27,COMPLETED
5320480,1,1,1704296568,1704296568,1704296597,29,COMPLETED
5320481,1,1,1704296568,1704296568,1704296598,30,COMPLETED
5320482,1,1,1704296568,1704296568,1704296598,30,COMPLETED
5320483,1,1,1704296568,1704296568,1704296597,29,COMPLETED
5320484,1,1,1704296568,1704296568,1704296595,27,COMPLETED
5320485,1,1,1704296568,1704296568,1704296596,28,COMPLETED
5320486,1,1,1704296568,1704296568,1704296596,28,COMPLETED
5320487,1,1,1704296568,1704296568,1704296595,27,COMPLETED
5320488,1,1,1704296568,1704296568,1704296596,28,COMPLETED
5320489,1,1,1704296568,1704296568,1704296596,28,COMPLETED
5320490,1,1,1704296568,1704296568,1704296598,30,COMPLETED
5320491,1,1,1704296568,1704296568,1704296596,28,COMPLETED
5320492,1,1,1704296569,1704296571,1704296614,43,COMPLETED
5320493,1,1,1704296569,1704296571,1704296614,43,COMPLETED
5320494,1,1,1704296569,1704296571,1704296614,43,COMPLETED
5320495,1,1,1704296569,1704296571,1704296614,43,COMPLETED
5320496,1,1,1704296569,1704296571,1704296613,42,COMPLETED
5320497,1,1,1704296569,1704296571,1704296613,42,COMPLETED
5320498,1,1,1704296569,1704296571,1704296613,42,COMPLETED
5320499,1,1,1704296569,1704296571,1704296614,43,COMPLETED
5320500,1,1,1704296569,1704296571,1704296614,43,COMPLETED
5320501,1,1,1704296569,1704296571,1704296613,42,COMPLETED
5320502,1,1,1704296570,1704296571,1704296613,42,COMPLETED
5320503,1,1,1704296570,1704296571,1704296614,43,COMPLETED
5320504,1,1,1704296570,1704296571,1704296613,42,COMPLETED
5320505,1,1,1704296570,1704296571,1704296612,41,COMPLETED
5320506,1,1,1704296570,1704296571,1704296612,41,COMPLETED
5320507,1,1,1704296570,1704296571,1704296612,41,COMPLETED
5320508,1,1,1704296570,1704296571,1704296614,43,COMPLETED
5320509,1,1,1704296570,1704296571,1704296612,41,COMPLETED
5320510,1,1,1704296570,1704296571,1704296612,41,COMPLETED
5320511,1,1,1704296570,1704296571,1704296613,42,COMPLETED
5320512,1,1,1704296571,1704296571,1704296612,41,COMPLETED
5320513,1,1,1704296571,1704296572,1704296612,40,COMPLETED
5320514,1,1,1704296571,1704296572,1704296613,41,COMPLETED
5320515,1,1,1704296571,1704296572,1704296612,40,COMPLETED
5320516,1,1,1704296571,1704296572,1704296612,40,COMPLETED
5320517,1,1,1704296571,1704296572,1704296612,40,COMPLETED
5320518,1,1,1704296571,1704296572,1704296613,41,COMPLETED
5320519,1,1,1704296571,1704296572,1704296612,40,COMPLETED
5320520,1,1,1704296571,1704296572,1704296612,40,COMPLETED
5320521,1,1,1704296572,1704296572,1704296612,40,COMPLETED
5320522,1,1,1704296581,1704296582,1704296626,44,COMPLETED
5320523,1,1,1704296582,1704296582,1704296626,44,COMPLETED
5320524,1,1,1704296582,1704296582,1704296628,46,COMPLETED
5320525,1,1,1704296582,1704296582,1704296626,44,COMPLETED
5320526,1,1,1704296598,1704296598,1704296626,28,COMPLETED
5320527,1,1,1704296599,1704296599,1704296626,27,COMPLETED
5320528,1,1,1704296599,1704296599,1704296626,27,COMPLETED
5320529,1,1,1704296599,1704296599,1704296630,31,COMPLETED
5320530,1,1,1704296599,1704296599,1704296627,28,COMPLETED
5320531,1,1,1704296599,1704296599,1704296626,27,COMPLETED
5320532,1,1,1704296599,1704296599,1704296628,29,COMPLETED
5320533,1,1,1704296599,1704296599,1704296627,28,COMPLETED
5320534,1,1,1704296599,1704296599,1704296628,29,COMPLETED
5320535,1,1,1704296599,1704296599,1704296625,26,COMPLETED
5320536,1,1,1704296599,1704296599,1704296625,26,COMPLETED
5320537,1,1,1704296600,1704296600,1704296626,26,COMPLETED
5320538,1,1,1704296600,1704296600,1704296626,26,COMPLETED
5320539,1,1,1704296600,1704296600,1704296625,25,COMPLETED
5320540,1,1,1704296600,1704296600,1704296625,25,COMPLETED
5320541,1,1,1704296600,1704296600,1704296626,26,COMPLETED
5320542,1,1,1704296600,1704296600,1704296625,25,COMPLETED
5320543,1,1,1704296600,1704296600,1704296628,28,COMPLETED
5320544,1,1,1704296600,1704296600,1704296626,26,COMPLETED
5320545,1,1,1704296600,1704296601,1704296625,24,COMPLETED
5320546,1,1,1704296600,1704296601,1704296625,24,COMPLETED
5320547,1,1,1704296601,1704296601,1704296626,25,COMPLETED
5320548,1,1,1704296601,1704296601,1704296626,25,COMPLETED
5320549,1,1,1704296601,1704296601,1704296625,24,COMPLETED
5320550,1,1,1704296601,1704296601,1704296625,24,COMPLETED
5320551,1,1,1704296601,1704296601,1704296625,24,COMPLETED
5320552,1,1,1704296613,1704296613,1704296665,52,COMPLETED
5320553,1,1,1704296613,1704296613,1704296665,52,COMPLETED
5320554,1,1,1704296613,1704296613,1704296659,46,COMPLETED
5320555,1,1,1704296613,1704296613,1704296663,50,COMPLETED
5320556,1,1,1704296613,1704296613,1704296661,48,COMPLETED
5320557,1,1,1704296613,1704296613,1704296661,48,COMPLETED
5320558,1,1,1704296613,1704296613,1704296659,46,COMPLETED
5320559,1,1,1704296613,1704296614,1704296668,54,COMPLETED
5320560,1,1,1704296614,1704296614,1704296660,46,COMPLETED
5320561,1,1,1704296614,1704296614,1704296662,48,COMPLETED
5320562,1,1,1704296614,1704296614,1704296664,50,COMPLETED
5320563,1,1,1704296614,1704296614,1704296663,49,COMPLETED
5320564,1,1,1704296614,1704296614,1704296666,52,COMPLETED
5320565,1,1,1704296614,1704296614,1704296664,50,COMPLETED
5320566,1,1,1704296614,1704296614,1704296659,45,COMPLETED
5320567,1,1,1704296614,1704296614,1704296659,45,COMPLETED
5320568,1,1,1704296614,1704296614,1704296664,50,COMPLETED
5320569,1,1,1704296615,1704296615,1704296668,53,COMPLETED
5320570,1,1,1704296615,1704296615,1704296664,49,COMPLETED
5320571,1,1,1704296615,1704296615,1704296661,46,COMPLETED
5320572,1,1,1704296615,1704296615,1704296665,50,COMPLETED
5320573,1,1,1704296615,1704296615,1704296661,46,COMPLETED
5320574,1,1,1704296615,1704296615,1704296660,45,COMPLETED
5320575,1,1,1704296615,1704296615,1704296659,44,COMPLETED
5320576,1,1,1704296615,1704296615,1704296661,46,COMPLETED
5320577,1,1,1704296615,1704296615,1704296661,46,COMPLETED
5320578,1,1,1704296615,1704296615,1704296668,53,COMPLETED
5320579,1,1,1704296615,1704296617,1704296660,43,COMPLETED
5320580,1,1,1704296616,1704296617,1704296662,45,COMPLETED
5320581,1,1,1704296616,1704296617,1704296665,48,COMPLETED
5320582,1,1,1704296616,1704296617,1704296662,45,COMPLETED
5320583,1,1,1704296616,1704296617,1704296668,51,COMPLETED
5320584,1,1,1704296616,1704296617,1704296664,47,COMPLETED
5320585,1,1,1704296616,1704296617,1704296665,48,COMPLETED
5320586,1,1,1704296616,1704296617,1704296668,51,COMPLETED
5320587,1,1,1704296616,1704296617,1704296664,47,COMPLETED
5320588,1,1,1704296616,1704296617,1704296660,43,COMPLETED
5320589,1,1,1704296616,1704296617,1704296662,45,COMPLETED
5320590,1,1,1704296617,1704296617,1704296659,42,COMPLETED
5320591,1,1,1704296617,1704296617,1704296661,44,COMPLETED
5320592,1,1,1704296617,1704296617,1704296659,42,COMPLETED
5320593,1,1,1704296617,1704296617,1704296664,47,COMPLETED
5320594,1,1,1704296617,1704296617,1704296664,47,COMPLETED
5320595,1,1,1704296617,1704296617,1704296661,44,COMPLETED
5320596,1,1,1704296617,1704296617,1704296661,44,COMPLETED
5320597,1,1,1704296617,1704296617,1704296660,43,COMPLETED
5320598,1,1,1704296617,1704296617,1704296659,42,COMPLETED
5320599,1,1,1704296618,1704296621,1704296664,43,COMPLETED
5320600,1,1,1704296618,1704296621,1704296659,38,COMPLETED
5320601,1,1,1704296618,1704296621,1704296663,42,COMPLETED
5320602,1,1,1704296618,1704296621,1704296664,43,COMPLETED
5320603,1,1,1704296618,1704296621,1704296668,47,COMPLETED
5320604,1,1,1704296618,1704296621,1704296669,48,COMPLETED
5320605,1,1,1704296618,1704296621,1704296662,41,COMPLETED
5320606,1,1,1704296618,1704296621,1704296659,38,COMPLETED
5320607,1,1,1704296618,1704296621,1704296662,41,COMPLETED
5320608,1,1,1704296618,1704296621,1704296659,38,COMPLETED
5320609,1,1,1704296619,1704296621,1704296663,42,COMPLETED
5320610,1,1,1704296619,1704296621,1704296662,41,COMPLETED
5320611,1,1,1704296619,1704296621,1704296664,43,COMPLETED
5320612,1,1,1704296619,1704296621,1704296665,44,COMPLETED
5320613,1,1,1704296619,1704296621,1704296665,44,COMPLETED
5320614,1,1,1704296619,1704296621,1704296660,39,COMPLETED
5320615,1,1,1704296619,1704296621,1704296663,42,COMPLETED
5320616,1,1,1704296619,1704296621,1704296665,44,COMPLETED
5320617,1,1,1704296619,1704296621,1704296664,43,COMPLETED
5320618,1,1,1704296619,1704296621,1704296663,42,COMPLETED
5320619,1,1,1704296620,1704296621,1704296661,40,COMPLETED
5320620,1,1,1704296620,1704296621,1704296664,43,COMPLETED
5320621,1,1,1704296620,1704296621,1704296668,47,COMPLETED
5320622,1,1,1704296620,1704296621,1704296662,41,COMPLETED
5320623,1,1,1704296620,1704296621,1704296663,42,COMPLETED
5320624,1,1,1704296620,1704296621,1704296664,43,COMPLETED
5320625,1,1,1704296620,1704296621,1704296664,43,COMPLETED
5320626,1,1,1704296620,1704296621,1704296662,41,COMPLETED
5320627,1,1,1704296620,1704296621,1704296659,38,COMPLETED
5320628,1,1,1704296620,1704296621,1704296659,38,COMPLETED
5320629,1,1,1704296620,1704296621,1704296663,42,COMPLETED
5320630,1,1,1704296621,1704296621,1704296662,41,COMPLETED
5320631,1,1,1704296621,1704296621,1704296665,44,COMPLETED
5320632,1,1,1704296621,1704296621,1704296663,42,COMPLETED
5320633,1,1,1704296621,1704296621,1704296663,42,COMPLETED
5320634,1,1,1704296621,1704296621,1704296662,41,COMPLETED
5320635,1,1,1704296621,1704296621,1704296659,38,COMPLETED
5320636,1,1,1704296621,1704296621,1704296662,41,COMPLETED
5320637,1,1,1704296621,1704296621,1704296663,42,COMPLETED
5320638,1,1,1704296621,1704296621,1704296664,43,COMPLETED
5320639,1,1,1704296622,1704296625,1704296660,35,COMPLETED
5320640,1,1,1704296622,1704296625,1704296659,34,COMPLETED
5320641,1,1,1704296622,1704296625,1704296659,34,COMPLETED
5320642,1,1,1704296622,1704296625,1704296659,34,COMPLETED
5320643,1,1,1704296622,1704296625,1704296659,34,COMPLETED
5320644,1,1,1704296622,1704296625,1704296659,34,COMPLETED
5320645,1,1,1704296622,1704296625,1704296659,34,COMPLETED
5320646,1,1,1704296622,1704296625,1704296660,35,COMPLETED
5320647,1,1,1704296622,1704296625,1704296662,37,COMPLETED
5320648,1,1,1704296622,1704296625,1704296659,34,COMPLETED
5320649,1,1,1704296622,1704296625,1704296661,36,COMPLETED
5320650,1,1,1704296623,1704296625,1704296659,34,COMPLETED
5320651,1,1,1704296623,1704296625,1704296659,34,COMPLETED
5320652,1,1,1704296623,1704296625,1704296659,34,COMPLETED
5320653,1,1,1704296623,1704296625,1704296659,34,COMPLETED
5320654,1,1,1704296623,1704296625,1704296659,34,COMPLETED
5320655,1,1,1704296623,1704296625,1704296659,34,COMPLETED
5320656,1,1,1704296623,1704296625,1704296659,34,COMPLETED
5320657,1,1,1704296623,1704296625,1704296659,34,COMPLETED
5320658,1,1,1704296623,1704296625,1704296659,34,COMPLETED
5320659,1,1,1704296624,1704296625,1704296659,34,COMPLETED
5320660,1,1,1704296624,1704296625,1704296662,37,COMPLETED
5320661,1,1,1704296624,1704296625,1704296664,39,COMPLETED
5320662,1,1,1704296624,1704296625,1704296662,37,COMPLETED
5320663,1,1,1704296624,1704296625,1704296666,41,COMPLETED
5320664,1,1,1704296624,1704296625,1704296664,39,COMPLETED
5320665,1,1,1704296624,1704296625,1704296661,36,COMPLETED
5320666,1,1,1704296624,1704296625,1704296660,35,COMPLETED
5320667,1,1,1704296624,1704296625,1704296664,39,COMPLETED
5320668,1,1,1704296624,1704296625,1704296663,38,COMPLETED
5320669,1,1,1704296625,1704296625,1704296666,41,COMPLETED
5320670,1,1,1704296625,1704296625,1704296665,40,COMPLETED
5320671,1,1,1704296625,1704296625,1704296664,39,COMPLETED
5320672,1,1,1704296625,1704296625,1704296665,40,COMPLETED
5320673,1,1,1704296625,1704296625,1704296659,34,COMPLETED
5320674,1,1,1704296625,1704296625,1704296659,34,COMPLETED
5320675,1,1,1704296625,1704296625,1704296659,34,COMPLETED
5320676,1,1,1704296625,1704296625,1704296659,34,COMPLETED
5320677,1,1,1704296625,1704296625,1704296659,34,COMPLETED
5320678,1,1,1704296626,1704296626,1704296659,33,COMPLETED
5320679,1,1,1704296626,1704296626,1704296659,33,COMPLETED
5320680,1,1,1704296626,1704296626,1704296659,33,COMPLETED
5320681,1,1,1704296626,1704296626,1704296659,33,COMPLETED
5320682,1,1,1704296626,1704296626,1704296659,33,COMPLETED
5320683,1,1,1704296626,1704296626,1704296659,33,COMPLETED
5320684,1,1,1704296626,1704296626,1704296659,33,COMPLETED
5320685,1,1,1704296626,1704296626,1704296659,33,COMPLETED
5320686,1,1,1704296626,1704296626,1704296659,33,COMPLETED
5320687,1,1,1704296626,1704296626,1704296662,36,COMPLETED
5320688,1,1,1704296627,1704296627,1704296663,36,COMPLETED
5320689,1,1,1704296627,1704296627,1704296664,37,COMPLETED
5320690,1,1,1704296627,1704296627,1704296663,36,COMPLETED
5320691,1,1,1704296627,1704296627,1704296666,39,COMPLETED
5320692,1,1,1704296627,1704296627,1704296664,37,COMPLETED
5320693,1,1,1704296627,1704296627,1704296663,36,COMPLETED
5320694,1,1,1704296627,1704296627,1704296661,34,COMPLETED
5320695,1,1,1704296627,1704296627,1704296663,36,COMPLETED
5320696,1,1,1704296627,1704296627,1704296664,37,COMPLETED
5320697,1,1,1704296627,1704296627,1704296659,32,COMPLETED
5320698,1,1,1704296628,1704296628,1704296659,31,COMPLETED
5320699,1,1,1704296628,1704296628,1704296659,31,COMPLETED
5320700,1,1,1704296628,1704296628,1704296668,40,COMPLETED
5320701,1,1,1704296628,1704296629,1704296661,32,COMPLETED
5320702,1,1,1704296628,1704296629,1704296659,30,COMPLETED
5320703,1,1,1704296628,1704296629,1704296661,32,COMPLETED
5320704,1,1,1704296628,1704296629,1704296662,33,COMPLETED
5320705,1,1,1704296628,1704296629,1704296664,35,COMPLETED
5320706,1,1,1704296628,1704296629,1704296659,30,COMPLETED
5320707,1,1,1704296628,1704296629,1704296661,32,COMPLETED
5320708,1,1,1704296629,1704296629,1704296663,34,COMPLETED
5320709,1,1,1704296629,1704296629,1704296661,32,COMPLETED
5320710,1,1,1704296629,1704296629,1704296659,30,COMPLETED
5320711,1,1,1704296629,1704296629,1704296661,32,COMPLETED
5320712,1,1,1704296629,1704296629,1704296659,30,COMPLETED
5320713,1,1,1704296629,1704296629,1704296662,33,COMPLETED
5320714,1,1,1704296629,1704296629,1704296660,31,COMPLETED
5320715,1,1,1704296629,1704296629,1704296665,36,COMPLETED
5320716,1,1,1704296629,1704296629,1704296659,30,COMPLETED
5320717,1,1,1704296629,1704296629,1704296662,33,COMPLETED
5320718,1,1,1704296630,1704296630,1704296660,30,COMPLETED
5320719,1,1,1704296630,1704296630,1704296660,30,COMPLETED
5320720,1,1,1704296630,1704296630,1704296663,33,COMPLETED
5320721,1,1,1704296630,1704296630,1704296660,30,COMPLETED
5320722,1,1,1704296630,1704296630,1704296659,29,COMPLETED
5320723,1,1,1704296630,1704296630,1704296661,31,COMPLETED
5320724,1,1,1704296630,1704296630,1704296662,32,COMPLETED
5320725,1,1,1704296630,1704296631,1704296681,50,COMPLETED
5320726,1,1,1704296630,1704296631,1704296681,50,COMPLETED
5320727,1,1,1704296630,1704296631,1704296681,50,COMPLETED
5320728,1,1,1704296656,1704296657,1704296681,24,COMPLETED
5320729,1,1,1704296657,1704296660,1704296687,27,COMPLETED
5320730,1,1,1704296658,1704296660,1704296688,28,COMPLETED
5320731,1,1,1704296658,1704296660,1704296687,27,COMPLETED
5320732,1,1,1704296658,1704296660,1704296687,27,COMPLETED
5320733,1,1,1704296658,1704296660,1704296689,29,COMPLETED
5320734,1,1,1704296658,1704296660,1704296687,27,COMPLETED
5320735,1,1,1704296658,1704296660,1704296688,28,COMPLETED
5320736,1,1,1704296658,1704296660,1704296686,26,COMPLETED
5320737,1,1,1704296659,1704296660,1704296687,27,COMPLETED
5320738,1,1,1704296659,1704296660,1704296688,28,COMPLETED
5320739,1,1,1704296659,1704296660,1704296687,27,COMPLETED
5320740,1,1,1704296659,1704296660,1704296688,28,COMPLETED
5320741,1,1,1704296659,1704296660,1704296689,29,COMPLETED
5320742,1,1,1704296659,1704296660,1704296687,27,COMPLETED
5320743,1,1,1704296659,1704296660,1704296687,27,COMPLETED
5320744,1,1,1704296659,1704296660,1704296688,28,COMPLETED
5320745,1,1,1704296659,1704296660,1704296686,26,COMPLETED
5320746,1,1,1704296659,1704296660,1704296687,27,COMPLETED
5320747,1,1,1704296659,1704296660,1704296689,29,COMPLETED
5320748,1,1,1704296659,1704296660,1704296687,27,COMPLETED
5320749,1,1,1704296659,1704296660,1704296686,26,COMPLETED
5320750,1,1,1704296659,1704296660,1704296692,32,COMPLETED
5320751,1,1,1704296660,1704296660,1704296688,28,COMPLETED
5320752,1,1,1704296670,1704296671,1704296704,33,COMPLETED
5320753,1,1,1704296671,1704296675,1704296707,32,COMPLETED
5320754,1,1,1704296671,1704296675,1704296705,30,COMPLETED
5320755,1,1,1704296671,1704296675,1704296706,31,COMPLETED
5320756,1,1,1704296671,1704296675,1704296704,29,COMPLETED
5320757,1,1,1704296671,1704296675,1704296705,30,COMPLETED
5320758,1,1,1704296671,1704296675,1704296707,32,COMPLETED
5320759,1,1,1704296671,1704296675,1704296705,30,COMPLETED
5320760,1,1,1704296671,1704296675,1704296707,32,COMPLETED
5320761,1,1,1704296671,1704296675,1704296705,30,COMPLETED
5320762,1,1,1704296671,1704296675,1704296706,31,COMPLETED
5320763,1,1,1704296672,1704296675,1704296704,29,COMPLETED
5320764,1,1,1704296672,1704296675,1704296705,30,COMPLETED
5320765,1,1,1704296672,1704296675,1704296704,29,COMPLETED
5320766,1,1,1704296672,1704296675,1704296704,29,COMPLETED
5320767,1,1,1704296672,1704296675,1704296705,30,COMPLETED
5320768,1,1,1704296672,1704296675,1704296705,30,COMPLETED
5320769,1,1,1704296672,1704296675,1704296704,29,COMPLETED
5320770,1,1,1704296672,1704296675,1704296703,28,COMPLETED
5320771,1,1,1704296673,1704296675,1704296706,31,COMPLETED
5320772,1,1,1704296673,1704296675,1704296705,30,COMPLETED
5320773,1,1,1704296673,1704296675,1704296704,29,COMPLETED
5320774,1,1,1704296673,1704296675,1704296705,30,COMPLETED
5320775,1,1,1704296673,1704296675,1704296704,29,COMPLETED
5320776,1,1,1704296673,1704296675,1704296706,31,COMPLETED
5320777,1,1,1704296673,1704296675,1704296706,31,COMPLETED
5320778,1,1,1704296673,1704296675,1704296705,30,COMPLETED
5320779,1,1,1704296673,1704296675,1704296706,31,COMPLETED
5320780,1,1,1704296673,1704296675,1704296705,30,COMPLETED
5320781,1,1,1704296673,1704296675,1704296704,29,COMPLETED
5320782,1,1,1704296673,1704296675,1704296703,28,COMPLETED
5320783,1,1,1704296674,1704296675,1704296704,29,COMPLETED
5320784,1,1,1704296674,1704296675,1704296699,24,COMPLETED
5320785,1,1,1704296674,1704296675,1704296697,22,COMPLETED
5320786,1,1,1704296674,1704296675,1704296698,23,COMPLETED
5320787,1,1,1704296674,1704296675,1704296697,22,COMPLETED
5320788,1,1,1704296674,1704296675,1704296698,23,COMPLETED
5320789,1,1,1704296674,1704296675,1704296697,22,COMPLETED
5320790,1,1,1704296674,1704296675,1704296697,22,COMPLETED
5320791,1,1,1704296675,1704296675,1704296698,23,COMPLETED
5320792,1,1,1704296675,1704296675,1704296698,23,COMPLETED
5320793,1,1,1704296675,1704296679,1704296705,26,COMPLETED
5320794,1,1,1704296675,1704296679,1704296704,25,COMPLETED
5320795,1,1,1704296675,1704296679,1704296704,25,COMPLETED
5320796,1,1,1704296675,1704296679,1704296704,25,COMPLETED
5320797,1,1,1704296675,1704296679,1704296709,30,COMPLETED
5320798,1,1,1704296675,1704296679,1704296708,29,COMPLETED
5320799,1,1,1704296675,1704296679,1704296708,29,COMPLETED
5320800,1,1,1704296676,1704296679,1704296709,30,COMPLETED
5320801,1,1,1704296676,1704296679,1704296708,29,COMPLETED
5320802,1,1,1704296676,1704296679,1704296705,26,COMPLETED
5320803,1,1,1704296676,1704296679,1704296708,29,COMPLETED
5320804,1,1,1704296676,1704296679,1704296709,30,COMPLETED
5320805,1,1,1704296676,1704296679,1704296708,29,COMPLETED
5320806,1,1,1704296676,1704296679,1704296709,30,COMPLETED
5320807,1,1,1704296676,1704296679,1704296709,30,COMPLETED
5320808,1,1,1704296676,1704296679,1704296709,30,COMPLETED
5320809,1,1,1704296676,1704296679,1704296709,30,COMPLETED
5320810,1,1,1704296676,1704296679,1704296708,29,COMPLETED
5320811,1,1,1704296676,1704296679,1704296708,29,COMPLETED
5320812,1,1,1704296676,1704296679,1704296709,30,COMPLETED
5320813,1,1,1704296677,1704296679,1704296708,29,COMPLETED
5320814,1,1,1704296677,1704296679,1704296708,29,COMPLETED
5320815,1,1,1704296677,1704296679,1704296709,30,COMPLETED
5320816,1,1,1704296677,1704296679,1704296708,29,COMPLETED
5320817,1,1,1704296677,1704296679,1704296709,30,COMPLETED
5320818,1,1,1704296677,1704296679,1704296710,31,COMPLETED
5320819,1,1,1704296677,1704296679,1704296708,29,COMPLETED
5320820,1,1,1704296677,1704296679,1704296712,33,COMPLETED
5320821,1,1,1704296677,1704296679,1704296707,28,COMPLETED
5320822,1,1,1704296678,1704296679,1704296707,28,COMPLETED
5320823,1,1,1704296678,1704296679,1704296708,29,COMPLETED
5320824,1,1,1704296678,1704296679,1704296709,30,COMPLETED
5320825,1,1,1704296678,1704296679,1704296707,28,COMPLETED
5320826,1,1,1704296678,1704296679,1704296708,29,COMPLETED
5320827,1,1,1704296678,1704296679,1704296708,29,COMPLETED
5320828,1,1,1704296678,1704296679,1704296711,32,COMPLETED
5320829,1,1,1704296678,1704296679,1704296708,29,COMPLETED
5320830,1,1,1704296678,1704296679,1704296708,29,COMPLETED
5320831,1,1,1704296678,1704296679,1704296708,29,COMPLETED
5320832,1,1,1704296678,1704296679,1704296704,25,COMPLETED
5320833,1,1,1704296679,1704296682,1704296734,52,COMPLETED
5320834,1,1,1704296679,1704296682,1704296731,49,COMPLETED
5320835,1,1,1704296679,1704296682,1704296733,51,COMPLETED
5320836,1,1,1704296679,1704296682,1704296734,52,COMPLETED
5320837,1,1,1704296680,1704296682,1704296732,50,COMPLETED
5320838,1,1,1704296680,1704296682,1704296732,50,COMPLETED
5320839,1,1,1704296680,1704296682,1704296736,54,COMPLETED
5320840,1,1,1704296680,1704296682,1704296731,49,COMPLETED
5320841,1,1,1704296680,1704296682,1704296733,51,COMPLETED
5320842,1,1,1704296680,1704296682,1704296731,49,COMPLETED
5320843,1,1,1704296680,1704296682,1704296732,50,COMPLETED
5320844,1,1,1704296680,1704296682,1704296733,51,COMPLETED
5320845,1,1,1704296680,1704296682,1704296733,51,COMPLETED
5320846,1,1,1704296680,1704296682,1704296734,52,COMPLETED
5320847,1,1,1704296680,1704296682,1704296732,50,COMPLETED
5320848,1,1,1704296680,1704296682,1704296733,51,COMPLETED
5320849,1,1,1704296680,1704296682,1704296731,49,COMPLETED
5320850,1,1,1704296680,1704296682,1704296733,51,COMPLETED
5320851,1,1,1704296680,1704296682,1704296735,53,COMPLETED
5320852,1,1,1704296680,1704296682,1704296732,50,COMPLETED
5320853,1,1,1704296681,1704296682,1704296733,51,COMPLETED
5320854,1,1,1704296681,1704296682,1704296732,50,COMPLETED
5320855,1,1,1704296681,1704296682,1704296734,52,COMPLETED
5320856,1,1,1704296681,1704296682,1704296731,49,COMPLETED
5320857,1,1,1704296681,1704296682,1704296734,52,COMPLETED
5320858,1,1,1704296681,1704296682,1704296730,48,COMPLETED
5320859,1,1,1704296681,1704296682,1704296736,54,COMPLETED
5320860,1,1,1704296681,1704296682,1704296732,50,COMPLETED
5320861,1,1,1704296681,1704296682,1704296733,51,COMPLETED
5320862,1,1,1704296681,1704296682,1704296733,51,COMPLETED
5320863,1,1,1704296682,1704296682,1704296722,40,COMPLETED
5320864,1,1,1704296682,1704296682,1704296722,40,COMPLETED
5320865,1,1,1704296682,1704296683,1704296722,39,COMPLETED
5320866,1,1,1704296682,1704296683,1704296722,39,COMPLETED
5320867,1,1,1704296682,1704296683,1704296731,48,COMPLETED
5320868,1,1,1704296682,1704296683,1704296735,52,COMPLETED
5320869,1,1,1704296682,1704296683,1704296731,48,COMPLETED
5320870,1,1,1704296682,1704296683,1704296733,50,COMPLETED
5320871,1,1,1704296683,1704296683,1704296733,50,COMPLETED
5320872,1,1,1704296683,1704296683,1704296732,49,COMPLETED
5320873,1,1,1704296683,1704296687,1704296737,50,COMPLETED
5320874,1,1,1704296683,1704296687,1704296734,47,COMPLETED
5320875,1,1,1704296683,1704296687,1704296731,44,COMPLETED
5320876,1,1,1704296683,1704296687,1704296732,45,COMPLETED
5320877,1,1,1704296683,1704296687,1704296733,46,COMPLETED
5320878,1,1,1704296683,1704296687,1704296737,50,COMPLETED
5320879,1,1,1704296683,1704296687,1704296732,45,COMPLETED
5320880,1,1,1704296683,1704296687,1704296732,45,COMPLETED
5320881,1,1,1704296683,1704296687,1704296733,46,COMPLETED
5320882,1,1,1704296683,1704296687,1704296733,46,COMPLETED
5320883,1,1,1704296684,1704296687,1704296731,44,COMPLETED
5320884,1,1,1704296685,1704296687,1704296733,46,COMPLETED
5320885,1,1,1704296685,1704296687,1704296733,46,COMPLETED
5320886,1,1,1704296685,1704296687,1704296737,50,COMPLETED
5320887,1,1,1704296685,1704296687,1704296733,46,COMPLETED
5320888,1,1,1704296685,1704296687,1704296733,46,COMPLETED
5320889,1,1,1704296685,1704296687,1704296734,47,COMPLETED
5320890,1,1,1704296685,1704296687,1704296731,44,COMPLETED
5320891,1,1,1704296685,1704296687,1704296732,45,COMPLETED
5320892,1,1,1704296685,1704296687,1704296733,46,COMPLETED
5320893,1,1,1704296685,1704296687,1704296732,45,COMPLETED
5320894,1,1,1704296685,1704296687,1704296731,44,COMPLETED
5320895,1,1,1704296685,1704296687,1704296732,45,COMPLETED
5320896,1,1,1704296685,1704296687,1704296737,50,COMPLETED
5320897,1,1,1704296685,1704296687,1704296733,46,COMPLETED
5320898,1,1,1704296685,1704296687,1704296732,45,COMPLETED
5320899,1,1,1704296685,1704296687,1704296732,45,COMPLETED
5320900,1,1,1704296685,1704296687,1704296733,46,COMPLETED
5320901,1,1,1704296685,1704296687,1704296731,44,COMPLETED
5320902,1,1,1704296685,1704296687,1704296731,44,COMPLETED
5320903,1,1,1704296686,1704296687,1704296731,44,COMPLETED
5320904,1,1,1704296686,1704296687,1704296733,46,COMPLETED
5320905,1,1,1704296686,1704296687,1704296733,46,COMPLETED
5320906,1,1,1704296686,1704296687,1704296734,47,COMPLETED
5320907,1,1,1704296686,1704296687,1704296731,44,COMPLETED
5320908,1,1,1704296687,1704296687,1704296722,35,COMPLETED
5320909,1,1,1704296687,1704296687,1704296722,35,COMPLETED
5320910,1,1,1704296687,1704296687,1704296722,35,COMPLETED
5320911,1,1,1704296687,1704296687,1704296723,36,COMPLETED
5320912,1,1,1704296687,1704296687,1704296722,35,COMPLETED
5320913,1,1,1704296687,1704296688,1704296722,34,COMPLETED
5320914,1,1,1704296688,1704296688,1704296724,36,COMPLETED
5320915,1,1,1704296688,1704296688,1704296723,35,COMPLETED
5320916,1,1,1704296688,1704296688,1704296724,36,COMPLETED
5320917,72,2,1704296779,1704296780,1704297301,521,COMPLETED
5320918,1,1,1704296827,1704296828,1704296888,60,COMPLETED
5320919,1,1,1704296827,1704296828,1704296877,49,COMPLETED
5320920,1,1,1704296827,1704296828,1704296877,49,COMPLETED
5320921,1,1,1704296827,1704296828,1704296877,49,COMPLETED
5320922,1,1,1704296827,1704296828,1704296888,60,COMPLETED
5320923,1,1,1704296827,1704296828,1704296879,51,COMPLETED
5320924,1,1,1704296827,1704296828,1704296877,49,COMPLETED
5320925,1,1,1704296827,1704296828,1704296881,53,COMPLETED
5320926,1,1,1704296827,1704296828,1704296876,48,COMPLETED
5320927,1,1,1704296827,1704296828,1704296883,55,COMPLETED
5320928,1,1,1704296827,1704296828,1704296877,49,COMPLETED
5320929,1,1,1704296827,1704296828,1704296883,55,COMPLETED
5320930,1,1,1704296827,1704296828,1704296877,49,COMPLETED
5320931,1,1,1704296827,1704296828,1704296888,60,COMPLETED
5320932,1,1,1704296827,1704296828,1704296876,48,COMPLETED
5320933,1,1,1704296827,1704296828,1704296886,58,COMPLETED
5320934,1,1,1704296828,1704296828,1704296877,49,COMPLETED
5320935,1,1,1704296828,1704296828,1704296883,55,COMPLETED
5320936,1,1,1704296828,1704296828,1704296886,58,COMPLETED
5320937,1,1,1704296828,1704296828,1704296880,52,COMPLETED
5320938,1,1,1704296828,1704296828,1704296885,57,COMPLETED
5320939,1,1,1704296828,1704296828,1704296880,52,COMPLETED
5320940,1,1,1704296828,1704296828,1704296888,60,COMPLETED
5320941,1,1,1704296828,1704296828,1704296877,49,COMPLETED
5320942,1,1,1704296828,1704296828,1704296877,49,COMPLETED
5320943,1,1,1704296828,1704296828,1704296880,52,COMPLETED
5320944,1,1,1704296828,1704296828,1704296881,53,COMPLETED
5320945,1,1,1704296828,1704296828,1704296880,52,COMPLETED
5320946,1,1,1704296828,1704296828,1704296880,52,COMPLETED
5320947,1,1,1704296828,1704296828,1704296877,49,COMPLETED
5320948,1,1,1704296828,1704296828,1704296876,48,COMPLETED
5320949,1,1,1704296828,1704296828,1704296880,52,COMPLETED
5320950,1,1,1704296828,1704296828,1704296879,51,COMPLETED
5320951,1,1,1704296828,1704296828,1704296879,51,COMPLETED
5320952,1,1,1704296828,1704296828,1704296877,49,COMPLETED
5320953,1,1,1704296828,1704296828,1704296877,49,COMPLETED
5320954,1,1,1704296828,1704296828,1704296877,49,COMPLETED
5320955,1,1,1704296828,1704296828,1704296877,49,COMPLETED
5320956,1,1,1704296828,1704296828,1704296890,62,COMPLETED
5320957,1,1,1704296828,1704296828,1704296885,57,COMPLETED
5320958,1,1,1704296828,1704296828,1704296882,54,COMPLETED
5320959,1,1,1704296828,1704296828,1704296878,50,COMPLETED
5320960,1,1,1704296828,1704296828,1704296877,49,COMPLETED
5320961,1,1,1704296828,1704296828,1704296886,58,COMPLETED
5320962,1,1,1704296828,1704296828,1704296878,50,COMPLETED
5320963,1,1,1704296828,1704296828,1704296877,49,COMPLETED
5320964,1,1,1704296828,1704296828,1704296881,53,COMPLETED
5320965,1,1,1704296828,1704296828,1704296877,49,COMPLETED
5320966,1,1,1704296828,1704296828,1704296876,48,COMPLETED
5320967,1,1,1704296828,1704296828,1704296882,54,COMPLETED
5320968,1,1,1704296828,1704296828,1704296882,54,COMPLETED
5320969,1,1,1704296828,1704296832,1704296877,45,COMPLETED
5320970,1,1,1704296828,1704296832,1704296876,44,COMPLETED
5320971,1,1,1704296828,1704296832,1704296882,50,COMPLETED
5320972,1,1,1704296828,1704296832,1704296877,45,COMPLETED
5320973,1,1,1704296828,1704296832,1704296880,48,COMPLETED
5320974,1,1,1704296828,1704296832,1704296885,53,COMPLETED
5320975,1,1,1704296828,1704296832,1704296888,56,COMPLETED
5320976,1,1,1704296828,1704296832,1704296883,51,COMPLETED
5320977,1,1,1704296828,1704296832,1704296886,54,COMPLETED
5320978,1,1,1704296828,1704296832,1704296882,50,COMPLETED
5320979,1,1,1704296828,1704296832,1704296884,52,COMPLETED
5320980,1,1,1704296829,1704296832,1704296884,52,COMPLETED
5320981,1,1,1704296829,1704296832,1704296877,45,COMPLETED
5320982,1,1,1704296829,1704296832,1704296887,55,COMPLETED
5320983,1,1,1704296829,1704296832,1704296887,55,COMPLETED
5320984,1,1,1704296829,1704296832,1704296884,52,COMPLETED
5320985,1,1,1704296829,1704296832,1704296882,50,COMPLETED
5320986,1,1,1704296829,1704296832,1704296882,50,COMPLETED
5320987,1,1,1704296829,1704296832,1704296882,50,COMPLETED
5320988,1,1,1704296829,1704296832,1704296887,55,COMPLETED
5320989,1,1,1704296829,1704296832,1704296876,44,COMPLETED
5320990,1,1,1704296829,1704296832,1704296889,57,COMPLETED
5320991,1,1,1704296829,1704296832,1704296888,56,COMPLETED
5320992,1,1,1704296829,1704296832,1704296879,47,COMPLETED
5320993,1,1,1704296829,1704296832,1704296876,44,COMPLETED
5320994,1,1,1704296829,1704296832,1704296879,47,COMPLETED
5320995,1,1,1704296829,1704296832,1704296881,49,COMPLETED
5320996,1,1,1704296829,1704296832,1704296883,51,COMPLETED
5320997,1,1,1704296829,1704296832,1704296881,49,COMPLETED
5320998,1,1,1704296829,1704296832,1704296876,44,COMPLETED
5320999,1,1,1704296829,1704296832,1704296884,52,COMPLETED
5321000,1,1,1704296829,1704296832,1704296881,49,COMPLETED
5321001,1,1,1704296829,1704296832,1704296885,53,COMPLETED
5321002,1,1,1704296829,1704296832,1704296876,44,COMPLETED
5321003,1,1,1704296829,1704296832,1704296888,56,COMPLETED
5321004,1,1,1704296829,1704296832,1704296883,51,COMPLETED
5321005,1,1,1704296829,1704296832,1704296881,49,COMPLETED
5321006,1,1,1704296829,1704296832,1704296876,44,COMPLETED
5321007,1,1,1704296829,1704296832,1704296888,56,COMPLETED
5321008,1,1,1704296829,1704296832,1704296879,47,COMPLETED
5321009,1,1,1704296829,1704296832,1704296876,44,COMPLETED
5321010,1,1,1704296829,1704296832,1704296876,44,COMPLETED
5321011,1,1,1704296829,1704296832,1704296876,44,COMPLETED
5321012,1,1,1704296829,1704296832,1704296876,44,COMPLETED
5321013,1,1,1704296829,1704296832,1704296876,44,COMPLETED
5321014,1,1,1704296829,1704296832,1704296877,45,COMPLETED
5321015,1,1,1704296829,1704296832,1704296883,51,COMPLETED
5321016,1,1,1704296829,1704296832,1704296879,47,COMPLETED
5321017,1,1,1704296829,1704296832,1704296880,48,COMPLETED
5321018,1,1,1704296829,1704296832,1704296876,44,COMPLETED
5321019,1,1,1704296829,1704296832,1704296876,44,COMPLETED
5321020,1,1,1704296829,1704296832,1704296877,45,COMPLETED
5321021,1,1,1704296829,1704296832,1704296885,53,COMPLETED
5321022,1,1,1704296829,1704296832,1704296880,48,COMPLETED
5321023,1,1,1704296829,1704296832,1704296877,45,COMPLETED
5321024,1,1,1704296829,1704296832,1704296879,47,COMPLETED
5321025,1,1,1704296830,1704296832,1704296881,49,COMPLETED
5321026,1,1,1704296830,1704296832,1704296877,45,COMPLETED
5321027,1,1,1704296830,1704296832,1704296883,51,COMPLETED
5321028,1,1,1704296830,1704296832,1704296885,53,COMPLETED
5321029,1,1,1704296830,1704296832,1704296887,55,COMPLETED
5321030,1,1,1704296830,1704296832,1704296881,49,COMPLETED
5321031,1,1,1704296830,1704296832,1704296880,48,COMPLETED
5321032,1,1,1704296830,1704296832,1704296880,48,COMPLETED
5321033,1,1,1704296830,1704296832,1704296880,48,COMPLETED
5321034,1,1,1704296830,1704296832,1704296876,44,COMPLETED
5321035,1,1,1704296830,1704296832,1704296876,44,COMPLETED
5321036,1,1,1704296830,1704296832,1704296876,44,COMPLETED
5321037,1,1,1704296830,1704296832,1704296884,52,COMPLETED
5321038,1,1,1704296830,1704296832,1704296881,49,COMPLETED
5321039,1,1,1704296830,1704296832,1704296881,49,COMPLETED
5321040,1,1,1704296830,1704296832,1704296885,53,COMPLETED
5321041,1,1,1704296830,1704296832,1704296883,51,COMPLETED
5321042,1,1,1704296830,1704296832,1704296877,45,COMPLETED
5321043,1,1,1704296830,1704296832,1704296876,44,COMPLETED
5321044,1,1,1704296830,1704296832,1704296881,49,COMPLETED
5321045,1,1,1704296830,1704296832,1704296883,51,COMPLETED
5321046,1,1,1704296830,1704296832,1704296880,48,COMPLETED
5321047,1,1,1704296830,1704296832,1704296883,51,COMPLETED
5321048,1,1,1704296830,1704296832,1704296888,56,COMPLETED
5321049,1,1,1704296830,1704296832,1704296879,47,COMPLETED
5321050,1,1,1704296830,1704296832,1704296883,51,COMPLETED
5321051,1,1,1704296830,1704296832,1704296876,44,COMPLETED
5321052,1,1,1704296830,1704296832,1704296889,57,COMPLETED
5321053,1,1,1704296830,1704296832,1704296876,44,COMPLETED
5321054,1,1,1704296830,1704296832,1704296887,55,COMPLETED
5321055,1,1,1704296830,1704296832,1704296876,44,COMPLETED
5321056,1,1,1704296830,1704296832,1704296877,45,COMPLETED
5321057,1,1,1704296830,1704296832,1704296883,51,COMPLETED
5321058,1,1,1704296830,1704296832,1704296884,52,COMPLETED
5321059,1,1,1704296830,1704296832,1704296883,51,COMPLETED
5321060,1,1,1704296830,1704296832,1704296876,44,COMPLETED
5321061,1,1,1704296830,1704296832,1704296880,48,COMPLETED
5321062,1,1,1704296830,1704296832,1704296883,51,COMPLETED
5321063,1,1,1704296830,1704296832,1704296876,44,COMPLETED
5321064,1,1,1704296830,1704296832,1704296886,54,COMPLETED
5321065,1,1,1704296830,1704296832,1704296881,49,COMPLETED
5321066,1,1,1704296830,1704296832,1704296883,51,COMPLETED
5321067,1,1,1704296830,1704296832,1704296878,46,COMPLETED
5321068,1,1,1704296830,1704296832,1704296880,48,COMPLETED
5321069,1,1,1704296830,1704296832,1704296885,53,COMPLETED
5321070,1,1,1704296830,1704296832,1704296885,53,COMPLETED
5321071,1,1,1704296830,1704296832,1704296883,51,COMPLETED
5321072,1,1,1704296830,1704296832,1704296883,51,COMPLETED
5321073,1,1,1704296830,1704296832,1704296876,44,COMPLETED
5321074,1,1,1704296830,1704296832,1704296881,49,COMPLETED
5321075,1,1,1704296831,1704296832,1704296885,53,COMPLETED
5321076,1,1,1704296831,1704296832,1704296876,44,COMPLETED
5321077,1,1,1704296831,1704296832,1704296876,44,COMPLETED
5321078,1,1,1704296831,1704296832,1704296881,49,COMPLETED
5321079,1,1,1704296831,1704296832,1704296881,49,COMPLETED
5321080,1,1,1704296831,1704296832,1704296885,53,COMPLETED
5321081,1,1,1704296831,1704296832,1704296878,46,COMPLETED
5321082,1,1,1704296831,1704296832,1704296881,49,COMPLETED
5321083,1,1,1704296831,1704296832,1704296878,46,COMPLETED
5321084,1,1,1704296831,1704296832,1704296885,53,COMPLETED
5321085,1,1,1704296831,1704296832,1704296881,49,COMPLETED
5321086,1,1,1704296831,1704296832,1704296876,44,COMPLETED
5321087,1,1,1704296831,1704296832,1704296883,51,COMPLETED
5321088,1,1,1704296831,1704296832,1704296885,53,COMPLETED
5321089,1,1,1704296831,1704296832,1704296880,48,COMPLETED
5321090,1,1,1704296831,1704296832,1704296877,45,COMPLETED
5321091,1,1,1704296831,1704296832,1704296877,45,COMPLETED
5321092,1,1,1704296831,1704296832,1704296883,51,COMPLETED
5321093,1,1,1704296831,1704296832,1704296881,49,COMPLETED
5321094,1,1,1704296831,1704296832,1704296883,51,COMPLETED
5321095,1,1,1704296831,1704296832,1704296883,51,COMPLETED
5321096,1,1,1704296831,1704296832,1704296881,49,COMPLETED
5321097,1,1,1704296831,1704296832,1704296885,53,COMPLETED
5321098,1,1,1704296831,1704296832,1704296876,44,COMPLETED
5321099,1,1,1704296831,1704296832,1704296876,44,COMPLETED
5321100,1,1,1704296831,1704296832,1704296876,44,COMPLETED
5321101,1,1,1704296831,1704296832,1704296876,44,COMPLETED
5321102,1,1,1704296831,1704296832,1704296876,44,COMPLETED
5321103,1,1,1704296831,1704296832,1704296876,44,COMPLETED
5321104,1,1,1704296831,1704296832,1704296876,44,COMPLETED
5321105,1,1,1704296831,1704296832,1704296876,44,COMPLETED
5321106,1,1,1704296831,1704296832,1704296876,44,COMPLETED
5321107,1,1,1704296831,1704296832,1704296876,44,COMPLETED
5321108,1,1,1704296831,1704296832,1704296876,44,COMPLETED
5321109,1,1,1704296831,1704296832,1704296876,44,COMPLETED
5321110,1,1,1704296831,1704296832,1704296876,44,COMPLETED
5321111,1,1,1704296831,1704296832,1704296876,44,COMPLETED
5321112,1,1,1704296831,1704296832,1704296876,44,COMPLETED
5321113,1,1,1704296831,1704296832,1704296876,44,COMPLETED
5321114,1,1,1704296831,1704296832,1704296876,44,COMPLETED
5321115,1,1,1704296831,1704296832,1704296876,44,COMPLETED
5321116,1,1,1704296831,1704296832,1704296876,44,COMPLETED
5321117,1,1,1704296831,1704296832,1704296876,44,COMPLETED
5321119,1,1,1704296876,1704296876,1704296906,30,COMPLETED
5321120,1,1,1704296877,1704296877,1704296906,29,COMPLETED
5321121,1,1,1704296877,1704296877,1704296906,29,COMPLETED
5321122,1,1,1704296877,1704296877,1704296906,29,COMPLETED
5321123,1,1,1704296878,1704296878,1704296905,27,COMPLETED
5321124,1,1,1704296879,1704296879,1704296919,40,COMPLETED
5321125,1,1,1704296879,1704296879,1704296922,43,COMPLETED
5321126,1,1,1704296879,1704296879,1704296918,39,COMPLETED
5321127,1,1,1704296880,1704296880,1704296918,38,COMPLETED
5321128,1,1,1704296880,1704296880,1704296916,36,COMPLETED
5321129,1,1,1704296880,1704296880,1704296917,37,COMPLETED
5321130,1,1,1704296881,1704296881,1704296918,37,COMPLETED
5321131,1,1,1704296881,1704296881,1704296918,37,COMPLETED
5321132,1,1,1704296881,1704296882,1704296920,38,COMPLETED
5321133,1,1,1704296881,1704296882,1704296916,34,COMPLETED
5321134,1,1,1704296882,1704296882,1704296919,37,COMPLETED
5321135,1,1,1704296882,1704296882,1704296916,34,COMPLETED
5321136,1,1,1704296882,1704296882,1704296916,34,COMPLETED
5321137,1,1,1704296882,1704296882,1704296918,36,COMPLETED
5321138,1,1,1704296882,1704296882,1704296919,37,COMPLETED
5321139,1,1,1704296882,1704296882,1704296917,35,COMPLETED
5321140,1,1,1704296882,1704296882,1704296916,34,COMPLETED
5321141,1,1,1704296882,1704296882,1704296922,40,COMPLETED
5321142,1,1,1704296882,1704296882,1704296905,23,COMPLETED
5321143,1,1,1704296883,1704296883,1704296916,33,COMPLETED
5321144,1,1,1704296883,1704296883,1704296919,36,COMPLETED
5321145,1,1,1704296883,1704296883,1704296919,36,COMPLETED
5321146,1,1,1704296883,1704296883,1704296917,34,COMPLETED
5321147,1,1,1704296883,1704296883,1704296918,35,COMPLETED
5321148,1,1,1704296883,1704296883,1704296918,35,COMPLETED
5321149,1,1,1704296883,1704296883,1704296916,33,COMPLETED
5321150,1,1,1704296883,1704296883,1704296916,33,COMPLETED
5321151,1,1,1704296883,1704296883,1704296918,35,COMPLETED
5321152,1,1,1704296895,1704296895,1704296922,27,COMPLETED
5321153,1,1,1704296895,1704296895,1704296922,27,COMPLETED
5321154,1,1,1704296895,1704296895,1704296922,27,COMPLETED
5321155,1,1,1704296895,1704296895,1704296923,28,COMPLETED
5321156,1,1,1704296895,1704296895,1704296924,29,COMPLETED
5321157,1,1,1704296895,1704296895,1704296923,28,COMPLETED
5321158,1,1,1704296896,1704296899,1704296927,28,COMPLETED
5321159,1,1,1704296896,1704296899,1704296929,30,COMPLETED
5321160,1,1,1704296896,1704296899,1704296927,28,COMPLETED
5321161,1,1,1704296896,1704296899,1704296942,43,COMPLETED
5321162,1,1,1704296896,1704296899,1704296938,39,COMPLETED
5321163,1,1,1704296896,1704296899,1704296943,44,COMPLETED
5321164,1,1,1704296896,1704296899,1704296941,42,COMPLETED
5321165,1,1,1704296896,1704296899,1704296939,40,COMPLETED
5321166,1,1,1704296896,1704296899,1704296946,47,COMPLETED
5321167,1,1,1704296896,1704296899,1704296938,39,COMPLETED
5321168,1,1,1704296897,1704296899,1704296935,36,COMPLETED
5321169,1,1,1704296897,1704296899,1704296938,39,COMPLETED
5321170,1,1,1704296897,1704296899,1704296944,45,COMPLETED
5321171,1,1,1704296897,1704296899,1704296940,41,COMPLETED
5321172,1,1,1704296897,1704296899,1704296937,38,COMPLETED
5321173,1,1,1704296897,1704296899,1704296940,41,COMPLETED
5321174,1,1,1704296897,1704296899,1704296944,45,COMPLETED
5321175,1,1,1704296897,1704296899,1704296938,39,COMPLETED
5321176,1,1,1704296897,1704296899,1704296941,42,COMPLETED
5321177,1,1,1704296897,1704296899,1704296935,36,COMPLETED
5321178,1,1,1704296898,1704296899,1704296938,39,COMPLETED
5321179,1,1,1704296898,1704296899,1704296937,38,COMPLETED
5321180,1,1,1704296898,1704296899,1704296937,38,COMPLETED
5321181,1,1,1704296898,1704296899,1704296935,36,COMPLETED
5321182,1,1,1704296898,1704296899,1704296935,36,COMPLETED
5321183,1,1,1704296898,1704296899,1704296941,42,COMPLETED
5321184,1,1,1704296898,1704296899,1704296936,37,COMPLETED
5321185,1,1,1704296898,1704296899,1704296939,40,COMPLETED
5321186,1,1,1704296898,1704296899,1704296937,38,COMPLETED
5321187,1,1,1704296898,1704296899,1704296938,39,COMPLETED
5321188,1,1,1704296899,1704296899,1704296938,39,COMPLETED
5321189,1,1,1704296899,1704296899,1704296942,43,COMPLETED
5321190,1,1,1704296899,1704296899,1704296938,39,COMPLETED
5321191,1,1,1704296899,1704296899,1704296936,37,COMPLETED
5321192,1,1,1704296899,1704296899,1704296944,45,COMPLETED
5321193,1,1,1704296899,1704296899,1704296941,42,COMPLETED
5321194,1,1,1704296899,1704296899,1704296940,41,COMPLETED
5321195,1,1,1704296899,1704296899,1704296936,37,COMPLETED
5321196,1,1,1704296899,1704296899,1704296938,39,COMPLETED
5321197,1,1,1704296899,1704296899,1704296939,40,COMPLETED
5321198,1,1,1704296900,1704296902,1704296940,38,COMPLETED
5321199,1,1,1704296900,1704296902,1704296944,42,COMPLETED
5321200,1,1,1704296900,1704296902,1704296940,38,COMPLETED
5321201,1,1,1704296900,1704296902,1704296941,39,COMPLETED
5321202,1,1,1704296900,1704296902,1704296939,37,COMPLETED
5321203,1,1,1704296900,1704296902,1704296940,38,COMPLETED
5321204,1,1,1704296900,1704296902,1704296939,37,COMPLETED
5321205,1,1,1704296900,1704296902,1704296940,38,COMPLETED
5321206,1,1,1704296900,1704296902,1704296935,33,COMPLETED
5321207,1,1,1704296900,1704296902,1704296941,39,COMPLETED
5321208,1,1,1704296901,1704296902,1704296939,37,COMPLETED
5321209,1,1,1704296901,1704296902,1704296941,39,COMPLETED
5321210,1,1,1704296901,1704296902,1704296938,36,COMPLETED
5321211,1,1,1704296901,1704296902,1704296941,39,COMPLETED
5321212,1,1,1704296901,1704296902,1704296935,33,COMPLETED
5321213,1,1,1704296901,1704296902,1704296941,39,COMPLETED
5321215,1,1,1704296901,1704296902,1704296937,35,COMPLETED
5321216,1,1,1704296901,1704296902,1704296937,35,COMPLETED
5321217,1,1,1704296901,1704296902,1704296939,37,COMPLETED
5321214,1,1,1704296901,1704296902,1704297137,235,COMPLETED
5321218,1,1,1704296902,1704296902,1704296941,39,COMPLETED
5321219,1,1,1704296902,1704296902,1704296938,36,COMPLETED
5321220,1,1,1704296902,1704296902,1704296937,35,COMPLETED
5321221,1,1,1704296902,1704296902,1704296939,37,COMPLETED
5321222,1,1,1704296902,1704296902,1704296938,36,COMPLETED
5321223,1,1,1704296902,1704296902,1704296939,37,COMPLETED
5321224,1,1,1704296902,1704296902,1704296944,42,COMPLETED
5321225,1,1,1704296902,1704296902,1704296937,35,COMPLETED
5321226,1,1,1704296902,1704296902,1704296940,38,COMPLETED
5321227,1,1,1704296902,1704296905,1704296946,41,COMPLETED
5321228,1,1,1704296903,1704296905,1704296949,44,COMPLETED
5321229,1,1,1704296903,1704296905,1704296947,42,COMPLETED
5321230,1,1,1704296903,1704296905,1704296945,40,COMPLETED
5321231,1,1,1704296903,1704296905,1704296946,41,COMPLETED
5321232,1,1,1704296903,1704296905,1704296954,49,COMPLETED
5321233,1,1,1704296903,1704296905,1704296952,47,COMPLETED
5321234,1,1,1704296903,1704296905,1704296956,51,COMPLETED
5321235,1,1,1704296903,1704296905,1704296960,55,COMPLETED
5321236,1,1,1704296903,1704296905,1704296951,46,COMPLETED
5321237,1,1,1704296903,1704296905,1704296950,45,COMPLETED
5321238,1,1,1704296904,1704296905,1704296954,49,COMPLETED
5321239,1,1,1704296904,1704296905,1704296953,48,COMPLETED
5321240,1,1,1704296904,1704296905,1704296955,50,COMPLETED
5321241,1,1,1704296904,1704296905,1704296955,50,COMPLETED
5321242,1,1,1704296904,1704296905,1704296956,51,COMPLETED
5321243,1,1,1704296904,1704296905,1704296955,50,COMPLETED
5321244,1,1,1704296904,1704296905,1704296954,49,COMPLETED
5321245,1,1,1704296904,1704296905,1704296954,49,COMPLETED
5321246,1,1,1704296904,1704296905,1704296955,50,COMPLETED
5321247,1,1,1704296904,1704296905,1704296955,50,COMPLETED
5321248,1,1,1704296905,1704296905,1704296955,50,COMPLETED
5321249,1,1,1704296905,1704296905,1704296956,51,COMPLETED
5321250,1,1,1704296905,1704296906,1704296954,48,COMPLETED
5321251,1,1,1704296905,1704296906,1704296955,49,COMPLETED
5321252,1,1,1704296905,1704296906,1704296952,46,COMPLETED
5321253,1,1,1704296905,1704296906,1704296953,47,COMPLETED
5321254,1,1,1704296905,1704296906,1704296955,49,COMPLETED
5321255,1,1,1704296905,1704296906,1704296954,48,COMPLETED
5321256,1,1,1704296905,1704296906,1704296960,54,COMPLETED
5321257,1,1,1704296905,1704296906,1704296950,44,COMPLETED
5321258,1,1,1704296906,1704296906,1704296955,49,COMPLETED
5321259,1,1,1704296906,1704296906,1704296952,46,COMPLETED
5321260,1,1,1704296906,1704296906,1704296958,52,COMPLETED
5321261,1,1,1704296906,1704296906,1704296959,53,COMPLETED
5321262,1,1,1704296906,1704296906,1704296954,48,COMPLETED
5321263,1,1,1704296906,1704296906,1704296952,46,COMPLETED
5321264,1,1,1704296906,1704296906,1704296957,51,COMPLETED
5321265,1,1,1704296906,1704296906,1704296955,49,COMPLETED
5321266,1,1,1704296906,1704296907,1704296952,45,COMPLETED
5321267,1,1,1704296906,1704296907,1704296951,44,COMPLETED
5321268,1,1,1704296907,1704296907,1704296946,39,COMPLETED
5321269,1,1,1704296907,1704296907,1704296954,47,COMPLETED
5321270,1,1,1704296907,1704296907,1704296943,36,COMPLETED
5321271,1,1,1704296907,1704296907,1704296944,37,COMPLETED
5321272,1,1,1704296907,1704296907,1704296943,36,COMPLETED
5321273,1,1,1704296907,1704296907,1704296942,35,COMPLETED
5321274,1,1,1704296907,1704296907,1704296944,37,COMPLETED
5321275,1,1,1704296907,1704296907,1704296942,35,COMPLETED
5321276,1,1,1704296907,1704296907,1704296942,35,COMPLETED
5321277,1,1,1704296907,1704296907,1704296949,42,COMPLETED
5321278,1,1,1704296908,1704296910,1704296963,53,COMPLETED
5321279,1,1,1704296908,1704296910,1704296964,54,COMPLETED
5321280,1,1,1704296908,1704296910,1704296962,52,COMPLETED
5321281,1,1,1704296908,1704296910,1704296963,53,COMPLETED
5321282,1,1,1704296908,1704296910,1704296962,52,COMPLETED
5321283,1,1,1704296908,1704296910,1704296964,54,COMPLETED
5321284,1,1,1704296908,1704296910,1704296963,53,COMPLETED
5321285,1,1,1704296908,1704296910,1704296962,52,COMPLETED
5321286,1,1,1704296908,1704296910,1704296963,53,COMPLETED
5321287,1,1,1704296908,1704296910,1704296962,52,COMPLETED
5321288,1,1,1704296909,1704296910,1704296963,53,COMPLETED
5321289,1,1,1704296909,1704296910,1704296960,50,COMPLETED
5321290,1,1,1704296909,1704296910,1704296962,52,COMPLETED
5321291,1,1,1704296909,1704296910,1704296961,51,COMPLETED
5321292,1,1,1704296909,1704296910,1704296963,53,COMPLETED
5321293,1,1,1704296909,1704296910,1704296962,52,COMPLETED
5321294,1,1,1704296909,1704296910,1704296961,51,COMPLETED
5321295,1,1,1704296909,1704296910,1704296962,52,COMPLETED
5321296,1,1,1704296909,1704296910,1704296964,54,COMPLETED
5321297,1,1,1704296909,1704296910,1704296963,53,COMPLETED
5321298,1,1,1704296910,1704296910,1704296962,52,COMPLETED
5321299,1,1,1704296910,1704296910,1704296962,52,COMPLETED
5321300,1,1,1704296910,1704296910,1704296962,52,COMPLETED
5321301,1,1,1704296910,1704296910,1704296962,52,COMPLETED
5321302,1,1,1704296910,1704296910,1704296963,53,COMPLETED
5321303,1,1,1704296910,1704296910,1704296961,51,COMPLETED
5321304,1,1,1704296910,1704296910,1704296961,51,COMPLETED
5321305,1,1,1704296910,1704296914,1704296956,42,COMPLETED
5321306,1,1,1704296911,1704296914,1704296955,41,COMPLETED
5321307,1,1,1704296911,1704296914,1704296961,47,COMPLETED
5321308,1,1,1704296911,1704296914,1704296957,43,COMPLETED
5321309,1,1,1704296911,1704296914,1704296957,43,COMPLETED
5321310,1,1,1704296911,1704296914,1704296956,42,COMPLETED
5321311,1,1,1704296911,1704296914,1704296957,43,COMPLETED
5321312,1,1,1704296911,1704296914,1704296957,43,COMPLETED
5321313,1,1,1704296911,1704296914,1704296955,41,COMPLETED
5321314,1,1,1704296911,1704296914,1704296955,41,COMPLETED
5321315,1,1,1704296911,1704296914,1704296957,43,COMPLETED
5321316,1,1,1704296912,1704296914,1704296962,48,COMPLETED
5321317,1,1,1704296912,1704296914,1704296956,42,COMPLETED
5321318,1,1,1704296912,1704296914,1704296956,42,COMPLETED
5321319,1,1,1704296922,1704296923,1704296995,72,COMPLETED
5321320,1,1,1704296922,1704296923,1704296995,72,COMPLETED
5321321,1,1,1704296922,1704296923,1704296993,70,COMPLETED
5321322,1,1,1704296939,1704296939,1704296997,58,COMPLETED
5321323,1,1,1704296939,1704296939,1704296993,54,COMPLETED
5321324,1,1,1704296939,1704296939,1704296993,54,COMPLETED
5321325,1,1,1704296939,1704296939,1704296996,57,COMPLETED
5321326,1,1,1704296940,1704296940,1704296997,57,COMPLETED
5321327,1,1,1704296940,1704296940,1704296996,56,COMPLETED
5321328,1,1,1704296940,1704296940,1704296991,51,COMPLETED
5321329,1,1,1704296940,1704296940,1704296991,51,COMPLETED
5321330,1,1,1704296940,1704296940,1704296991,51,COMPLETED
5321331,1,1,1704296940,1704296940,1704296995,55,COMPLETED
5321332,1,1,1704296940,1704296940,1704296991,51,COMPLETED
5321333,1,1,1704296940,1704296940,1704296991,51,COMPLETED
5321334,1,1,1704296940,1704296940,1704296995,55,COMPLETED
5321335,1,1,1704296943,1704296943,1704296996,53,COMPLETED
5321336,1,1,1704296943,1704296944,1704296992,48,COMPLETED
5321337,1,1,1704296944,1704296944,1704296994,50,COMPLETED
5321338,1,1,1704296944,1704296944,1704296998,54,COMPLETED
5321339,1,1,1704296944,1704296944,1704296995,51,COMPLETED
5321340,1,1,1704296944,1704296944,1704296997,53,COMPLETED
5321341,1,1,1704296944,1704296944,1704296993,49,COMPLETED
5321342,1,1,1704296944,1704296944,1704296986,42,COMPLETED
5321343,1,1,1704296944,1704296944,1704296985,41,COMPLETED
5321344,1,1,1704296944,1704296944,1704296988,44,COMPLETED
5321345,1,1,1704296944,1704296944,1704296992,48,COMPLETED
5321346,1,1,1704296944,1704296944,1704296983,39,COMPLETED
5321347,1,1,1704296944,1704296944,1704296983,39,COMPLETED
5321348,1,1,1704296944,1704296945,1704296983,38,COMPLETED
5321349,1,1,1704296944,1704296945,1704296986,41,COMPLETED
5321350,1,1,1704296944,1704296945,1704296985,40,COMPLETED
5321351,1,1,1704296944,1704296945,1704296985,40,COMPLETED
5321352,1,1,1704296944,1704296945,1704296993,48,COMPLETED
5321353,1,1,1704296944,1704296945,1704296988,43,COMPLETED
5321354,1,1,1704296945,1704296945,1704296983,38,COMPLETED
5321355,1,1,1704296953,1704296953,1704296981,28,COMPLETED
5321356,1,1,1704296953,1704296953,1704296981,28,COMPLETED
5321357,1,1,1704296953,1704296953,1704296986,33,COMPLETED
5321358,1,1,1704296953,1704296953,1704296982,29,COMPLETED
5321359,1,1,1704296953,1704296953,1704296983,30,COMPLETED
5321360,1,1,1704296955,1704296955,1704296981,26,COMPLETED
5321361,1,1,1704296955,1704296955,1704296981,26,COMPLETED
5321362,1,1,1704296955,1704296955,1704296981,26,COMPLETED
5321363,1,1,1704296955,1704296955,1704296981,26,COMPLETED
5321364,1,1,1704296955,1704296955,1704296994,39,COMPLETED
5321365,1,1,1704296955,1704296955,1704296993,38,COMPLETED
5321366,1,1,1704296955,1704296955,1704296996,41,COMPLETED
5321367,1,1,1704296955,1704296955,1704296994,39,COMPLETED
5321368,1,1,1704296955,1704296956,1704296995,39,COMPLETED
5321369,1,1,1704296955,1704296956,1704296996,40,COMPLETED
5321370,1,1,1704296955,1704296956,1704296992,36,COMPLETED
5321371,1,1,1704296956,1704296956,1704296996,40,COMPLETED
5321372,1,1,1704296956,1704296956,1704296993,37,COMPLETED
5321373,1,1,1704296956,1704296956,1704296998,42,COMPLETED
5321374,1,1,1704296956,1704296956,1704296996,40,COMPLETED
5321375,1,1,1704296956,1704296956,1704296995,39,COMPLETED
5321376,1,1,1704296956,1704296956,1704296995,39,COMPLETED
5321377,1,1,1704296956,1704296956,1704296997,41,COMPLETED
5321378,1,1,1704296956,1704296956,1704297000,44,COMPLETED
5321379,1,1,1704296956,1704296956,1704296999,43,COMPLETED
5321380,1,1,1704296956,1704296956,1704296990,34,COMPLETED
5321381,1,1,1704296956,1704296956,1704296998,42,COMPLETED
5321382,1,1,1704296956,1704296956,1704296994,38,COMPLETED
5321383,1,1,1704296956,1704296956,1704296994,38,COMPLETED
5321384,1,1,1704296956,1704296956,1704296996,40,COMPLETED
5321385,1,1,1704296956,1704296956,1704296994,38,COMPLETED
5321386,1,1,1704296956,1704296956,1704296995,39,COMPLETED
5321387,1,1,1704296956,1704296956,1704296992,36,COMPLETED
5321388,1,1,1704296957,1704296957,1704296995,38,COMPLETED
5321389,1,1,1704296957,1704296957,1704296993,36,COMPLETED
5321390,1,1,1704296957,1704296957,1704296994,37,COMPLETED
5321391,1,1,1704296957,1704296957,1704296996,39,COMPLETED
5321392,1,1,1704296957,1704296957,1704296989,32,COMPLETED
5321393,1,1,1704296957,1704296957,1704296994,37,COMPLETED
5321394,1,1,1704296957,1704296957,1704296995,38,COMPLETED
5321395,1,1,1704296957,1704296957,1704296999,42,COMPLETED
5321396,1,1,1704296957,1704296957,1704297003,46,COMPLETED
5321397,1,1,1704296957,1704296958,1704296995,37,COMPLETED
5321398,1,1,1704296957,1704296958,1704296997,39,COMPLETED
5321399,1,1,1704296958,1704296958,1704296995,37,COMPLETED
5321400,1,1,1704296958,1704296958,1704296994,36,COMPLETED
5321401,1,1,1704296958,1704296958,1704297008,50,COMPLETED
5321402,1,1,1704296958,1704296958,1704296990,32,COMPLETED
5321403,1,1,1704296958,1704296958,1704296991,33,COMPLETED
5321404,1,1,1704296958,1704296958,1704296995,37,COMPLETED
5321405,1,1,1704296958,1704296958,1704296991,33,COMPLETED
5321406,1,1,1704296958,1704296958,1704296993,35,COMPLETED
5321407,1,1,1704296958,1704296958,1704296992,34,COMPLETED
5321408,1,1,1704296958,1704296958,1704296993,35,COMPLETED
5321409,1,1,1704296959,1704296959,1704296990,31,COMPLETED
5321410,1,1,1704296959,1704296959,1704296993,34,COMPLETED
5321411,1,1,1704296959,1704296959,1704296997,38,COMPLETED
5321412,1,1,1704296959,1704296959,1704296995,36,COMPLETED
5321413,1,1,1704296959,1704296959,1704296990,31,COMPLETED
5321414,1,1,1704296959,1704296959,1704296994,35,COMPLETED
5321415,1,1,1704296959,1704296959,1704296993,34,COMPLETED
5321416,1,1,1704296959,1704296959,1704296998,39,COMPLETED
5321417,1,1,1704296959,1704296959,1704296994,35,COMPLETED
5321418,1,1,1704296959,1704296960,1704296995,35,COMPLETED
5321419,1,1,1704296960,1704296960,1704296998,38,COMPLETED
5321420,1,1,1704296960,1704296960,1704296993,33,COMPLETED
5321421,1,1,1704296960,1704296960,1704296994,34,COMPLETED
5321422,1,1,1704296960,1704296960,1704296990,30,COMPLETED
5321423,1,1,1704296960,1704296960,1704296988,28,COMPLETED
5321424,1,1,1704296960,1704296960,1704296992,32,COMPLETED
5321425,1,1,1704296960,1704296960,1704296999,39,COMPLETED
5321426,1,1,1704296960,1704296961,1704296990,29,COMPLETED
5321427,1,1,1704296960,1704296961,1704296997,36,COMPLETED
5321428,1,1,1704296960,1704296961,1704296995,34,COMPLETED
5321429,1,1,1704296961,1704296961,1704296990,29,COMPLETED
5321430,1,1,1704296961,1704296961,1704296990,29,COMPLETED
5321431,1,1,1704296961,1704296961,1704296995,34,COMPLETED
5321432,1,1,1704296961,1704296961,1704296990,29,COMPLETED
5321433,1,1,1704296961,1704296961,1704296992,31,COMPLETED
5321434,1,1,1704296961,1704296961,1704296995,34,COMPLETED
5321435,1,1,1704296961,1704296961,1704296999,38,COMPLETED
5321436,1,1,1704296961,1704296961,1704296992,31,COMPLETED
5321437,1,1,1704296961,1704296961,1704296994,33,COMPLETED
5321438,1,1,1704296962,1704296962,1704297000,38,COMPLETED
5321439,1,1,1704296962,1704296962,1704297002,40,COMPLETED
5321440,1,1,1704296962,1704296962,1704297002,40,COMPLETED
5321441,1,1,1704296962,1704296962,1704297001,39,COMPLETED
5321442,1,1,1704296962,1704296962,1704297005,43,COMPLETED
5321443,1,1,1704296962,1704296962,1704297001,39,COMPLETED
5321444,1,1,1704296962,1704296962,1704297002,40,COMPLETED
5321445,1,1,1704296962,1704296962,1704297002,40,COMPLETED
5321446,1,1,1704296962,1704296962,1704297002,40,COMPLETED
5321447,1,1,1704296962,1704296962,1704297005,43,COMPLETED
5321448,1,1,1704296963,1704296964,1704297008,44,COMPLETED
5321449,1,1,1704296964,1704296964,1704297008,44,COMPLETED
5321450,1,1,1704296964,1704296964,1704297002,38,COMPLETED
5321451,1,1,1704296964,1704296964,1704297002,38,COMPLETED
5321452,1,1,1704296964,1704296964,1704297005,41,COMPLETED
5321453,1,1,1704296964,1704296964,1704297003,39,COMPLETED
5321454,1,1,1704296964,1704296964,1704297005,41,COMPLETED
5321455,1,1,1704296964,1704296964,1704297005,41,COMPLETED
5321456,1,1,1704296964,1704296964,1704297005,41,COMPLETED
5321457,1,1,1704296964,1704296964,1704297009,45,COMPLETED
5321458,1,1,1704296964,1704296965,1704297008,43,COMPLETED
5321459,1,1,1704296965,1704296965,1704297006,41,COMPLETED
5321460,1,1,1704296965,1704296965,1704297003,38,COMPLETED
5321461,1,1,1704296965,1704296965,1704297003,38,COMPLETED
5321462,1,1,1704296965,1704296966,1704297006,40,COMPLETED
5321463,1,1,1704296965,1704296966,1704297005,39,COMPLETED
5321464,1,1,1704296965,1704296966,1704297005,39,COMPLETED
5321465,1,1,1704296965,1704296966,1704297005,39,COMPLETED
5321466,1,1,1704296965,1704296966,1704297005,39,COMPLETED
5321467,1,1,1704296965,1704296966,1704297003,37,COMPLETED
5321468,1,1,1704296965,1704296966,1704297003,37,COMPLETED
5321469,1,1,1704296965,1704296966,1704297003,37,COMPLETED
5321470,1,1,1704296966,1704296970,1704297020,50,COMPLETED
5321471,1,1,1704296966,1704296970,1704297021,51,COMPLETED
5321473,1,1,1704296966,1704296970,1704297026,56,COMPLETED
5321474,1,1,1704296966,1704296970,1704297023,53,COMPLETED
5321475,1,1,1704296966,1704296970,1704297024,54,COMPLETED
5321476,1,1,1704296966,1704296970,1704297022,52,COMPLETED
5321477,1,1,1704296966,1704296970,1704297020,50,COMPLETED
5321472,360,10,1704296966,1704297448,1704469669,172221,FAILED
5321478,1,1,1704296967,1704296970,1704297024,54,COMPLETED
5321479,1,1,1704296967,1704296970,1704297024,54,COMPLETED
5321480,1,1,1704296967,1704296970,1704297022,52,COMPLETED
5321481,1,1,1704296967,1704296970,1704297025,55,COMPLETED
5321482,1,1,1704296967,1704296970,1704297023,53,COMPLETED
5321483,1,1,1704296967,1704296970,1704297020,50,COMPLETED
5321484,1,1,1704296967,1704296970,1704297021,51,COMPLETED
5321485,1,1,1704296967,1704296970,1704297022,52,COMPLETED
5321486,1,1,1704296967,1704296970,1704297022,52,COMPLETED
5321487,1,1,1704296967,1704296970,1704297020,50,COMPLETED
5321488,1,1,1704296967,1704296970,1704297023,53,COMPLETED
5321489,1,1,1704296968,1704296970,1704297021,51,COMPLETED
5321490,1,1,1704296968,1704296970,1704297022,52,COMPLETED
5321491,1,1,1704296968,1704296970,1704297023,53,COMPLETED
5321492,1,1,1704296968,1704296970,1704297023,53,COMPLETED
5321493,1,1,1704296968,1704296970,1704297023,53,COMPLETED
5321494,1,1,1704296968,1704296970,1704297026,56,COMPLETED
5321495,1,1,1704296968,1704296970,1704297024,54,COMPLETED
5321496,1,1,1704296968,1704296970,1704297021,51,COMPLETED
5321497,1,1,1704296968,1704296970,1704297022,52,COMPLETED
5321498,1,1,1704296968,1704296970,1704297014,44,COMPLETED
5321499,1,1,1704296968,1704296970,1704297025,55,COMPLETED
5321500,1,1,1704296968,1704296970,1704297020,50,COMPLETED
5321501,1,1,1704296969,1704296970,1704297023,53,COMPLETED
5321502,1,1,1704296969,1704296970,1704297020,50,COMPLETED
5321503,1,1,1704296969,1704296970,1704297022,52,COMPLETED
5321504,1,1,1704296969,1704296970,1704297021,51,COMPLETED
5321505,1,1,1704296969,1704296970,1704297025,55,COMPLETED
5321506,1,1,1704296969,1704296970,1704297026,56,COMPLETED
5321507,1,1,1704296969,1704296970,1704297022,52,COMPLETED
5321508,1,1,1704296969,1704296970,1704297023,53,COMPLETED
5321509,1,1,1704296969,1704296970,1704297023,53,COMPLETED
5321510,1,1,1704296969,1704296970,1704297021,51,COMPLETED
5321511,1,1,1704296970,1704296970,1704297023,53,COMPLETED
5321512,1,1,1704296970,1704296974,1704297025,51,COMPLETED
5321513,1,1,1704296970,1704296974,1704297020,46,COMPLETED
5321514,1,1,1704296970,1704296974,1704297023,49,COMPLETED
5321515,1,1,1704296970,1704296974,1704297021,47,COMPLETED
5321516,1,1,1704296970,1704296974,1704297025,51,COMPLETED
5321517,1,1,1704296970,1704296974,1704297020,46,COMPLETED
5321518,1,1,1704296970,1704296974,1704297022,48,COMPLETED
5321519,1,1,1704296982,1704296982,1704297023,41,COMPLETED
5321520,1,1,1704296982,1704296982,1704297022,40,COMPLETED
5321521,1,1,1704296982,1704296982,1704297020,38,COMPLETED
5321522,1,1,1704296982,1704296982,1704297023,41,COMPLETED
5321523,1,1,1704296983,1704296983,1704297025,42,COMPLETED
5321524,1,1,1704296983,1704296983,1704297023,40,COMPLETED
5321525,1,1,1704296998,1704296998,1704297049,51,COMPLETED
5321526,1,1,1704296998,1704296998,1704297049,51,COMPLETED
5321527,1,1,1704296998,1704296998,1704297053,55,COMPLETED
5321528,1,1,1704296998,1704296998,1704297050,52,COMPLETED
5321529,1,1,1704296998,1704296998,1704297049,51,COMPLETED
5321530,1,1,1704296998,1704296998,1704297049,51,COMPLETED
5321531,1,1,1704296998,1704296998,1704297049,51,COMPLETED
5321532,1,1,1704296999,1704296999,1704297049,50,COMPLETED
5321533,1,1,1704296999,1704296999,1704297049,50,COMPLETED
5321534,1,1,1704296999,1704296999,1704297049,50,COMPLETED
5321535,1,1,1704296999,1704296999,1704297049,50,COMPLETED
5321536,1,1,1704296999,1704296999,1704297049,50,COMPLETED
5321537,1,1,1704296999,1704296999,1704297049,50,COMPLETED
5321538,1,1,1704296999,1704296999,1704297049,50,COMPLETED
5321539,1,1,1704296999,1704296999,1704297049,50,COMPLETED
5321540,1,1,1704296999,1704296999,1704297049,50,COMPLETED
5321541,1,1,1704297000,1704297000,1704297054,54,COMPLETED
5321542,1,1,1704297000,1704297000,1704297053,53,COMPLETED
5321543,1,1,1704297000,1704297000,1704297056,56,COMPLETED
5321544,1,1,1704297000,1704297000,1704297053,53,COMPLETED
5321545,1,1,1704297000,1704297000,1704297056,56,COMPLETED
5321546,1,1,1704297000,1704297000,1704297058,58,COMPLETED
5321547,1,1,1704297000,1704297000,1704297055,55,COMPLETED
5321548,1,1,1704297000,1704297000,1704297053,53,COMPLETED
5321549,1,1,1704297000,1704297000,1704297056,56,COMPLETED
5321550,1,1,1704297000,1704297000,1704297056,56,COMPLETED
5321551,1,1,1704297001,1704297001,1704297055,54,COMPLETED
5321552,1,1,1704297001,1704297001,1704297055,54,COMPLETED
5321553,1,1,1704297001,1704297001,1704297058,57,COMPLETED
5321554,1,1,1704297001,1704297001,1704297058,57,COMPLETED
5321555,1,1,1704297001,1704297001,1704297056,55,COMPLETED
5321556,1,1,1704297001,1704297001,1704297053,52,COMPLETED
5321557,1,1,1704297001,1704297001,1704297056,55,COMPLETED
5321558,1,1,1704297001,1704297001,1704297055,54,COMPLETED
5321559,1,1,1704297001,1704297001,1704297056,55,COMPLETED
5321560,1,1,1704297001,1704297001,1704297054,53,COMPLETED
5321561,1,1,1704297014,1704297014,1704297055,41,COMPLETED
5321562,1,1,1704297014,1704297016,1704297056,40,COMPLETED
5321563,1,1,1704297014,1704297016,1704297056,40,COMPLETED
5321564,1,1,1704297015,1704297016,1704297056,40,COMPLETED
5321565,1,1,1704297015,1704297016,1704297057,41,COMPLETED
5321566,1,1,1704297015,1704297016,1704297054,38,COMPLETED
5321567,1,1,1704297015,1704297016,1704297057,41,COMPLETED
5321568,1,1,1704297016,1704297018,1704297056,38,COMPLETED
5321569,1,1,1704297016,1704297018,1704297055,37,COMPLETED
5321570,1,1,1704297016,1704297018,1704297055,37,COMPLETED
5321571,1,1,1704297016,1704297018,1704297053,35,COMPLETED
5321572,1,1,1704297016,1704297018,1704297054,36,COMPLETED
5321573,1,1,1704297017,1704297018,1704297055,37,COMPLETED
5321574,1,1,1704297017,1704297018,1704297056,38,COMPLETED
5321575,1,1,1704297017,1704297018,1704297058,40,COMPLETED
5321576,1,1,1704297017,1704297018,1704297056,38,COMPLETED
5321577,1,1,1704297017,1704297018,1704297057,39,COMPLETED
5321578,1,1,1704297017,1704297018,1704297058,40,COMPLETED
5321579,1,1,1704297017,1704297018,1704297057,39,COMPLETED
5321580,1,1,1704297017,1704297018,1704297057,39,COMPLETED
5321581,1,1,1704297017,1704297018,1704297057,39,COMPLETED
5321582,1,1,1704297017,1704297018,1704297057,39,COMPLETED
5321583,1,1,1704297017,1704297018,1704297057,39,COMPLETED
5321584,1,1,1704297017,1704297018,1704297055,37,COMPLETED
5321585,1,1,1704297017,1704297018,1704297054,36,COMPLETED
5321586,1,1,1704297017,1704297018,1704297054,36,COMPLETED
5321587,1,1,1704297018,1704297018,1704297055,37,COMPLETED
5321588,1,1,1704297018,1704297018,1704297057,39,COMPLETED
5321589,1,1,1704297018,1704297021,1704297055,34,COMPLETED
5321590,1,1,1704297018,1704297021,1704297053,32,COMPLETED
5321591,1,1,1704297018,1704297021,1704297055,34,COMPLETED
5321592,1,1,1704297018,1704297021,1704297054,33,COMPLETED
5321593,1,1,1704297018,1704297021,1704297057,36,COMPLETED
5321594,1,1,1704297018,1704297021,1704297058,37,COMPLETED
5321595,1,1,1704297018,1704297021,1704297057,36,COMPLETED
5321596,1,1,1704297018,1704297021,1704297057,36,COMPLETED
5321597,1,1,1704297018,1704297021,1704297053,32,COMPLETED
5321598,1,1,1704297018,1704297021,1704297053,32,COMPLETED
5321599,1,1,1704297018,1704297021,1704297055,34,COMPLETED
5321600,1,1,1704297018,1704297021,1704297057,36,COMPLETED
5321601,1,1,1704297018,1704297021,1704297054,33,COMPLETED
5321602,1,1,1704297018,1704297021,1704297055,34,COMPLETED
5321603,1,1,1704297018,1704297021,1704297055,34,COMPLETED
5321604,1,1,1704297018,1704297021,1704297057,36,COMPLETED
5321605,1,1,1704297018,1704297021,1704297056,35,COMPLETED
5321606,1,1,1704297018,1704297021,1704297055,34,COMPLETED
5321607,1,1,1704297018,1704297021,1704297054,33,COMPLETED
5321608,1,1,1704297018,1704297021,1704297055,34,COMPLETED
5321609,1,1,1704297019,1704297021,1704297058,37,COMPLETED
5321610,1,1,1704297019,1704297021,1704297055,34,COMPLETED
5321611,1,1,1704297019,1704297021,1704297058,37,COMPLETED
5321612,1,1,1704297019,1704297021,1704297054,33,COMPLETED
5321613,1,1,1704297019,1704297021,1704297055,34,COMPLETED
5321614,1,1,1704297019,1704297021,1704297057,36,COMPLETED
5321615,1,1,1704297019,1704297021,1704297055,34,COMPLETED
5321616,1,1,1704297019,1704297021,1704297055,34,COMPLETED
5321617,1,1,1704297019,1704297021,1704297054,33,COMPLETED
5321618,1,1,1704297019,1704297021,1704297054,33,COMPLETED
5321619,1,1,1704297020,1704297021,1704297055,34,COMPLETED
5321620,1,1,1704297020,1704297021,1704297055,34,COMPLETED
5321621,1,1,1704297020,1704297021,1704297055,34,COMPLETED
5321622,1,1,1704297020,1704297021,1704297056,35,COMPLETED
5321623,1,1,1704297020,1704297021,1704297056,35,COMPLETED
5321624,1,1,1704297020,1704297021,1704297056,35,COMPLETED
5321625,1,1,1704297020,1704297021,1704297057,36,COMPLETED
5321626,1,1,1704297020,1704297021,1704297055,34,COMPLETED
5321627,1,1,1704297020,1704297021,1704297055,34,COMPLETED
5321628,1,1,1704297020,1704297021,1704297056,35,COMPLETED
5321629,1,1,1704297021,1704297021,1704297056,35,COMPLETED
5321630,1,1,1704297021,1704297021,1704297056,35,COMPLETED
5321631,1,1,1704297021,1704297021,1704297055,34,COMPLETED
5321632,1,1,1704297022,1704297022,1704297055,33,COMPLETED
5321633,1,1,1704297022,1704297022,1704297055,33,COMPLETED
5321634,1,1,1704297022,1704297022,1704297055,33,COMPLETED
5321635,1,1,1704297022,1704297022,1704297055,33,COMPLETED
5321636,1,1,1704297022,1704297022,1704297056,34,COMPLETED
5321637,1,1,1704297022,1704297022,1704297056,34,COMPLETED
5321638,1,1,1704297022,1704297022,1704297055,33,COMPLETED
5321639,1,1,1704297022,1704297022,1704297055,33,COMPLETED
5321640,1,1,1704297022,1704297022,1704297056,34,COMPLETED
5321641,1,1,1704297022,1704297022,1704297053,31,COMPLETED
5321642,1,1,1704297022,1704297022,1704297054,32,COMPLETED
5321643,1,1,1704297022,1704297023,1704297056,33,COMPLETED
5321644,36,1,1704297031,1704297032,1704297093,61,TIMEOUT
5321645,1,1,1704297070,1704297071,1704297075,4,COMPLETED
5321647,1,1,1704297070,1704297092,1704297095,3,COMPLETED
5321649,1,1,1704297155,1704297156,1704297159,3,COMPLETED
5321651,1,1,1704297155,1704297172,1704297177,5,COMPLETED
5321653,1,1,1704297168,1704297169,1704297219,50,COMPLETED
5321654,1,1,1704297168,1704297169,1704297218,49,COMPLETED
5321655,1,1,1704297168,1704297169,1704297218,49,COMPLETED
5321656,1,1,1704297168,1704297169,1704297221,52,COMPLETED
5321657,1,1,1704297168,1704297169,1704297223,54,COMPLETED
5321658,1,1,1704297168,1704297169,1704297223,54,COMPLETED
5321659,1,1,1704297168,1704297169,1704297224,55,COMPLETED
5321660,1,1,1704297168,1704297169,1704297223,54,COMPLETED
5321661,1,1,1704297168,1704297169,1704297221,52,COMPLETED
5321662,1,1,1704297168,1704297169,1704297221,52,COMPLETED
5321663,1,1,1704297168,1704297169,1704297218,49,COMPLETED
5321664,1,1,1704297168,1704297169,1704297223,54,COMPLETED
5321665,1,1,1704297168,1704297169,1704297221,52,COMPLETED
5321666,1,1,1704297168,1704297169,1704297218,49,COMPLETED
5321667,1,1,1704297168,1704297169,1704297223,54,COMPLETED
5321668,1,1,1704297168,1704297169,1704297224,55,COMPLETED
5321669,1,1,1704297169,1704297169,1704297232,63,COMPLETED
5321670,1,1,1704297169,1704297169,1704297232,63,COMPLETED
5321671,1,1,1704297169,1704297169,1704297218,49,COMPLETED
5321672,1,1,1704297169,1704297169,1704297221,52,COMPLETED
5321673,1,1,1704297169,1704297169,1704297225,56,COMPLETED
5321674,1,1,1704297169,1704297169,1704297234,65,COMPLETED
5321675,1,1,1704297169,1704297169,1704297218,49,COMPLETED
5321676,1,1,1704297169,1704297169,1704297218,49,COMPLETED
5321677,1,1,1704297169,1704297169,1704297218,49,COMPLETED
5321678,1,1,1704297169,1704297169,1704297221,52,COMPLETED
5321679,1,1,1704297169,1704297171,1704297227,56,COMPLETED
5321680,1,1,1704297169,1704297171,1704297221,50,COMPLETED
5321681,1,1,1704297169,1704297171,1704297221,50,COMPLETED
5321682,1,1,1704297169,1704297171,1704297226,55,COMPLETED
5321683,1,1,1704297169,1704297171,1704297221,50,COMPLETED
5321684,1,1,1704297169,1704297171,1704297223,52,COMPLETED
5321685,1,1,1704297169,1704297171,1704297229,58,COMPLETED
5321686,1,1,1704297169,1704297171,1704297218,47,COMPLETED
5321687,1,1,1704297169,1704297171,1704297228,57,COMPLETED
5321688,1,1,1704297169,1704297171,1704297224,53,COMPLETED
5321689,1,1,1704297169,1704297171,1704297227,56,COMPLETED
5321690,1,1,1704297169,1704297171,1704297227,56,COMPLETED
5321691,1,1,1704297169,1704297171,1704297222,51,COMPLETED
5321692,1,1,1704297169,1704297171,1704297228,57,COMPLETED
5321693,1,1,1704297169,1704297171,1704297226,55,COMPLETED
5321694,1,1,1704297169,1704297171,1704297226,55,COMPLETED
5321695,1,1,1704297169,1704297171,1704297224,53,COMPLETED
5321696,1,1,1704297169,1704297171,1704297225,54,COMPLETED
5321697,1,1,1704297169,1704297171,1704297227,56,COMPLETED
5321698,1,1,1704297169,1704297171,1704297222,51,COMPLETED
5321699,1,1,1704297169,1704297171,1704297222,51,COMPLETED
5321700,1,1,1704297169,1704297171,1704297223,52,COMPLETED
5321701,1,1,1704297169,1704297171,1704297223,52,COMPLETED
5321702,1,1,1704297169,1704297171,1704297220,49,COMPLETED
5321703,1,1,1704297169,1704297171,1704297226,55,COMPLETED
5321704,1,1,1704297169,1704297171,1704297218,47,COMPLETED
5321705,1,1,1704297169,1704297171,1704297220,49,COMPLETED
5321706,1,1,1704297169,1704297171,1704297231,60,COMPLETED
5321707,1,1,1704297169,1704297171,1704297223,52,COMPLETED
5321708,1,1,1704297169,1704297171,1704297220,49,COMPLETED
5321709,1,1,1704297169,1704297171,1704297220,49,COMPLETED
5321710,1,1,1704297169,1704297171,1704297226,55,COMPLETED
5321711,1,1,1704297169,1704297171,1704297227,56,COMPLETED
5321712,1,1,1704297170,1704297171,1704297224,53,COMPLETED
5321713,1,1,1704297170,1704297171,1704297222,51,COMPLETED
5321714,1,1,1704297170,1704297171,1704297228,57,COMPLETED
5321715,1,1,1704297170,1704297171,1704297226,55,COMPLETED
5321716,1,1,1704297170,1704297171,1704297229,58,COMPLETED
5321717,1,1,1704297170,1704297172,1704297224,52,COMPLETED
5321718,1,1,1704297170,1704297172,1704297226,54,COMPLETED
5321719,1,1,1704297170,1704297172,1704297226,54,COMPLETED
5321720,1,1,1704297170,1704297172,1704297223,51,COMPLETED
5321721,1,1,1704297170,1704297172,1704297225,53,COMPLETED
5321722,1,1,1704297170,1704297172,1704297218,46,COMPLETED
5321723,1,1,1704297170,1704297172,1704297223,51,COMPLETED
5321724,1,1,1704297170,1704297172,1704297224,52,COMPLETED
5321725,1,1,1704297170,1704297172,1704297224,52,COMPLETED
5321726,1,1,1704297170,1704297172,1704297218,46,COMPLETED
5321727,1,1,1704297170,1704297172,1704297221,49,COMPLETED
5321728,1,1,1704297170,1704297172,1704297223,51,COMPLETED
5321729,1,1,1704297170,1704297172,1704297231,59,COMPLETED
5321730,1,1,1704297170,1704297172,1704297222,50,COMPLETED
5321731,1,1,1704297170,1704297172,1704297226,54,COMPLETED
5321732,1,1,1704297170,1704297172,1704297222,50,COMPLETED
5321733,1,1,1704297170,1704297172,1704297221,49,COMPLETED
5321734,1,1,1704297170,1704297172,1704297223,51,COMPLETED
5321735,1,1,1704297170,1704297172,1704297231,59,COMPLETED
5321736,1,1,1704297170,1704297172,1704297226,54,COMPLETED
5321737,1,1,1704297170,1704297172,1704297218,46,COMPLETED
5321738,1,1,1704297170,1704297172,1704297228,56,COMPLETED
5321739,1,1,1704297170,1704297172,1704297222,50,COMPLETED
5321740,1,1,1704297170,1704297172,1704297224,52,COMPLETED
5321741,1,1,1704297170,1704297172,1704297221,49,COMPLETED
5321742,1,1,1704297170,1704297172,1704297225,53,COMPLETED
5321743,1,1,1704297170,1704297172,1704297226,54,COMPLETED
5321744,1,1,1704297170,1704297172,1704297224,52,COMPLETED
5321745,1,1,1704297170,1704297172,1704297221,49,COMPLETED
5321746,1,1,1704297170,1704297172,1704297224,52,COMPLETED
5321747,1,1,1704297170,1704297172,1704297231,59,COMPLETED
5321748,1,1,1704297170,1704297172,1704297221,49,COMPLETED
5321749,1,1,1704297170,1704297172,1704297229,57,COMPLETED
5321750,1,1,1704297170,1704297172,1704297226,54,COMPLETED
5321751,1,1,1704297170,1704297172,1704297224,52,COMPLETED
5321752,1,1,1704297170,1704297172,1704297221,49,COMPLETED
5321753,1,1,1704297170,1704297172,1704297226,54,COMPLETED
5321754,1,1,1704297170,1704297172,1704297222,50,COMPLETED
5321755,1,1,1704297170,1704297172,1704297222,50,COMPLETED
5321756,1,1,1704297170,1704297172,1704297221,49,COMPLETED
5321757,1,1,1704297170,1704297172,1704297225,53,COMPLETED
5321758,1,1,1704297170,1704297172,1704297223,51,COMPLETED
5321759,1,1,1704297170,1704297172,1704297218,46,COMPLETED
5321760,1,1,1704297170,1704297172,1704297222,50,COMPLETED
5321761,1,1,1704297170,1704297172,1704297220,48,COMPLETED
5321762,1,1,1704297170,1704297172,1704297225,53,COMPLETED
5321763,1,1,1704297170,1704297172,1704297223,51,COMPLETED
5321764,1,1,1704297170,1704297172,1704297225,53,COMPLETED
5321765,1,1,1704297170,1704297172,1704297224,52,COMPLETED
5321766,1,1,1704297170,1704297172,1704297219,47,COMPLETED
5321767,1,1,1704297171,1704297172,1704297225,53,COMPLETED
5321768,1,1,1704297171,1704297172,1704297223,51,COMPLETED
5321769,1,1,1704297171,1704297172,1704297221,49,COMPLETED
5321770,1,1,1704297171,1704297172,1704297220,48,COMPLETED
5321771,1,1,1704297171,1704297172,1704297226,54,COMPLETED
5321772,1,1,1704297171,1704297172,1704297218,46,COMPLETED
5321773,1,1,1704297171,1704297172,1704297225,53,COMPLETED
5321774,1,1,1704297171,1704297172,1704297226,54,COMPLETED
5321775,1,1,1704297171,1704297172,1704297223,51,COMPLETED
5321776,1,1,1704297171,1704297172,1704297227,55,COMPLETED
5321777,1,1,1704297171,1704297172,1704297226,54,COMPLETED
5321778,1,1,1704297171,1704297172,1704297232,60,COMPLETED
5321779,1,1,1704297171,1704297172,1704297218,46,COMPLETED
5321780,1,1,1704297171,1704297172,1704297221,49,COMPLETED
5321781,1,1,1704297171,1704297172,1704297223,51,COMPLETED
5321782,1,1,1704297171,1704297172,1704297224,52,COMPLETED
5321783,1,1,1704297171,1704297172,1704297233,61,COMPLETED
5321784,1,1,1704297171,1704297172,1704297219,47,COMPLETED
5321785,1,1,1704297171,1704297172,1704297223,51,COMPLETED
5321786,1,1,1704297171,1704297172,1704297224,52,COMPLETED
5321787,1,1,1704297171,1704297172,1704297227,55,COMPLETED
5321788,1,1,1704297171,1704297172,1704297221,49,COMPLETED
5321789,1,1,1704297171,1704297172,1704297221,49,COMPLETED
5321790,1,1,1704297171,1704297172,1704297221,49,COMPLETED
5321791,1,1,1704297171,1704297172,1704297221,49,COMPLETED
5321792,1,1,1704297171,1704297172,1704297225,53,COMPLETED
5321793,1,1,1704297171,1704297172,1704297219,47,COMPLETED
5321794,1,1,1704297171,1704297172,1704297226,54,COMPLETED
5321795,1,1,1704297171,1704297172,1704297221,49,COMPLETED
5321796,1,1,1704297171,1704297172,1704297219,47,COMPLETED
5321797,1,1,1704297171,1704297172,1704297226,54,COMPLETED
5321798,1,1,1704297171,1704297172,1704297222,50,COMPLETED
5321799,1,1,1704297171,1704297172,1704297218,46,COMPLETED
5321800,1,1,1704297171,1704297172,1704297222,50,COMPLETED
5321801,1,1,1704297171,1704297172,1704297220,48,COMPLETED
5321802,1,1,1704297171,1704297172,1704297222,50,COMPLETED
5321803,1,1,1704297171,1704297172,1704297218,46,COMPLETED
5321804,1,1,1704297171,1704297172,1704297222,50,COMPLETED
5321805,1,1,1704297171,1704297172,1704297229,57,COMPLETED
5321806,1,1,1704297171,1704297172,1704297223,51,COMPLETED
5321807,1,1,1704297171,1704297172,1704297229,57,COMPLETED
5321808,1,1,1704297171,1704297172,1704297220,48,COMPLETED
5321809,1,1,1704297171,1704297172,1704297218,46,COMPLETED
5321810,1,1,1704297171,1704297172,1704297231,59,COMPLETED
5321811,1,1,1704297171,1704297172,1704297220,48,COMPLETED
5321812,1,1,1704297171,1704297172,1704297226,54,COMPLETED
5321813,1,1,1704297171,1704297172,1704297219,47,COMPLETED
5321814,1,1,1704297171,1704297172,1704297223,51,COMPLETED
5321815,1,1,1704297171,1704297172,1704297217,45,COMPLETED
5321816,1,1,1704297171,1704297172,1704297219,47,COMPLETED
5321817,1,1,1704297172,1704297173,1704297224,51,COMPLETED
5321818,1,1,1704297172,1704297173,1704297225,52,COMPLETED
5321819,1,1,1704297172,1704297173,1704297222,49,COMPLETED
5321820,1,1,1704297172,1704297173,1704297223,50,COMPLETED
5321821,1,1,1704297173,1704297173,1704297220,47,COMPLETED
5321822,1,1,1704297173,1704297173,1704297217,44,COMPLETED
5321823,1,1,1704297173,1704297173,1704297219,46,COMPLETED
5321824,1,1,1704297173,1704297173,1704297218,45,COMPLETED
5321825,1,1,1704297173,1704297175,1704297224,49,COMPLETED
5321826,1,1,1704297173,1704297175,1704297217,42,COMPLETED
5321827,1,1,1704297173,1704297175,1704297222,47,COMPLETED
5321828,1,1,1704297173,1704297175,1704297219,44,COMPLETED
5321829,1,1,1704297173,1704297175,1704297218,43,COMPLETED
5321830,1,1,1704297173,1704297175,1704297217,42,COMPLETED
5321831,1,1,1704297173,1704297175,1704297226,51,COMPLETED
5321832,1,1,1704297173,1704297175,1704297223,48,COMPLETED
5321833,1,1,1704297173,1704297175,1704297218,43,COMPLETED
5321834,1,1,1704297173,1704297175,1704297232,57,COMPLETED
5321835,1,1,1704297173,1704297175,1704297218,43,COMPLETED
5321836,1,1,1704297173,1704297175,1704297218,43,COMPLETED
5321837,1,1,1704297173,1704297175,1704297218,43,COMPLETED
5321838,1,1,1704297174,1704297175,1704297218,43,COMPLETED
5321839,1,1,1704297174,1704297175,1704297219,44,COMPLETED
5321840,1,1,1704297174,1704297175,1704297218,43,COMPLETED
5321841,1,1,1704297174,1704297175,1704297218,43,COMPLETED
5321842,1,1,1704297174,1704297175,1704297218,43,COMPLETED
5321843,1,1,1704297174,1704297175,1704297218,43,COMPLETED
5321844,1,1,1704297174,1704297175,1704297218,43,COMPLETED
5321845,1,1,1704297174,1704297175,1704297218,43,COMPLETED
5321846,1,1,1704297174,1704297175,1704297218,43,COMPLETED
5321847,1,1,1704297174,1704297175,1704297218,43,COMPLETED
5321848,1,1,1704297174,1704297175,1704297218,43,COMPLETED
5321849,1,1,1704297174,1704297175,1704297218,43,COMPLETED
5321850,1,1,1704297174,1704297175,1704297218,43,COMPLETED
5321851,1,1,1704297174,1704297175,1704297218,43,COMPLETED
5321852,1,1,1704297174,1704297175,1704297218,43,COMPLETED
5321853,360,10,1704297206,1704298446,1704470550,172104,FAILED
5321854,1,1,1704297218,1704297219,1704297250,31,COMPLETED
5321855,1,1,1704297220,1704297220,1704297249,29,COMPLETED
5321856,1,1,1704297220,1704297220,1704297249,29,COMPLETED
5321857,1,1,1704297220,1704297220,1704297249,29,COMPLETED
5321858,1,1,1704297220,1704297220,1704297249,29,COMPLETED
5321859,1,1,1704297221,1704297221,1704297249,28,COMPLETED
5321860,1,1,1704297221,1704297221,1704297249,28,COMPLETED
5321861,1,1,1704297221,1704297221,1704297264,43,COMPLETED
5321862,1,1,1704297221,1704297221,1704297250,29,COMPLETED
5321863,1,1,1704297222,1704297222,1704297262,40,COMPLETED
5321864,1,1,1704297222,1704297222,1704297262,40,COMPLETED
5321865,1,1,1704297222,1704297222,1704297261,39,COMPLETED
5321866,1,1,1704297222,1704297222,1704297262,40,COMPLETED
5321867,1,1,1704297222,1704297222,1704297259,37,COMPLETED
5321868,1,1,1704297222,1704297223,1704297262,39,COMPLETED
5321869,1,1,1704297223,1704297223,1704297261,38,COMPLETED
5321870,1,1,1704297223,1704297223,1704297261,38,COMPLETED
5321871,1,1,1704297223,1704297223,1704297261,38,COMPLETED
5321872,1,1,1704297223,1704297223,1704297261,38,COMPLETED
5321873,1,1,1704297223,1704297223,1704297261,38,COMPLETED
5321874,1,1,1704297223,1704297223,1704297261,38,COMPLETED
5321875,1,1,1704297223,1704297223,1704297261,38,COMPLETED
5321876,1,1,1704297223,1704297223,1704297261,38,COMPLETED
5321877,1,1,1704297224,1704297224,1704297261,37,COMPLETED
5321878,1,1,1704297225,1704297225,1704297261,36,COMPLETED
5321879,1,1,1704297225,1704297225,1704297261,36,COMPLETED
5321880,1,1,1704297225,1704297225,1704297261,36,COMPLETED
5321881,1,1,1704297225,1704297225,1704297261,36,COMPLETED
5321882,1,1,1704297225,1704297226,1704297261,35,COMPLETED
5321883,1,1,1704297226,1704297226,1704297261,35,COMPLETED
5321884,1,1,1704297226,1704297226,1704297262,36,COMPLETED
5321885,1,1,1704297226,1704297226,1704297261,35,COMPLETED
5321886,1,1,1704297226,1704297226,1704297261,35,COMPLETED
5321887,1,1,1704297236,1704297236,1704297263,27,COMPLETED
5321888,1,1,1704297236,1704297236,1704297264,28,COMPLETED
5321889,1,1,1704297236,1704297236,1704297264,28,COMPLETED
5321890,1,1,1704297236,1704297236,1704297263,27,COMPLETED
5321891,1,1,1704297236,1704297236,1704297264,28,COMPLETED
5321892,1,1,1704297236,1704297236,1704297263,27,COMPLETED
5321893,1,1,1704297236,1704297236,1704297264,28,COMPLETED
5321894,1,1,1704297237,1704297240,1704297269,29,COMPLETED
5321895,1,1,1704297237,1704297240,1704297269,29,COMPLETED
5321896,1,1,1704297237,1704297240,1704297269,29,COMPLETED
5321897,1,1,1704297237,1704297240,1704297269,29,COMPLETED
5321898,1,1,1704297237,1704297240,1704297283,43,COMPLETED
5321899,1,1,1704297237,1704297240,1704297281,41,COMPLETED
5321900,1,1,1704297237,1704297240,1704297284,44,COMPLETED
5321901,1,1,1704297237,1704297240,1704297280,40,COMPLETED
5321902,1,1,1704297237,1704297240,1704297283,43,COMPLETED
5321903,1,1,1704297237,1704297240,1704297281,41,COMPLETED
5321904,1,1,1704297238,1704297240,1704297284,44,COMPLETED
5321905,1,1,1704297238,1704297240,1704297282,42,COMPLETED
5321906,1,1,1704297238,1704297240,1704297279,39,COMPLETED
5321907,1,1,1704297238,1704297240,1704297284,44,COMPLETED
5321908,1,1,1704297238,1704297240,1704297281,41,COMPLETED
5321909,1,1,1704297238,1704297240,1704297280,40,COMPLETED
5321910,1,1,1704297238,1704297240,1704297282,42,COMPLETED
5321911,1,1,1704297238,1704297240,1704297283,43,COMPLETED
5321912,1,1,1704297238,1704297240,1704297286,46,COMPLETED
5321913,1,1,1704297238,1704297240,1704297286,46,COMPLETED
5321914,1,1,1704297239,1704297240,1704297279,39,COMPLETED
5321915,1,1,1704297239,1704297240,1704297281,41,COMPLETED
5321916,1,1,1704297239,1704297240,1704297282,42,COMPLETED
5321917,1,1,1704297239,1704297240,1704297284,44,COMPLETED
5321918,1,1,1704297239,1704297240,1704297280,40,COMPLETED
5321919,1,1,1704297239,1704297240,1704297281,41,COMPLETED
5321920,1,1,1704297239,1704297240,1704297282,42,COMPLETED
5321921,1,1,1704297239,1704297240,1704297280,40,COMPLETED
5321922,1,1,1704297239,1704297240,1704297279,39,COMPLETED
5321923,1,1,1704297239,1704297240,1704297279,39,COMPLETED
5321924,1,1,1704297240,1704297240,1704297282,42,COMPLETED
5321925,1,1,1704297240,1704297240,1704297282,42,COMPLETED
5321926,1,1,1704297240,1704297240,1704297281,41,COMPLETED
5321927,1,1,1704297240,1704297240,1704297286,46,COMPLETED
5321928,1,1,1704297240,1704297240,1704297279,39,COMPLETED
5321929,1,1,1704297240,1704297240,1704297281,41,COMPLETED
5321930,1,1,1704297240,1704297240,1704297281,41,COMPLETED
5321931,1,1,1704297240,1704297240,1704297283,43,COMPLETED
5321932,1,1,1704297240,1704297240,1704297280,40,COMPLETED
5321933,1,1,1704297240,1704297240,1704297280,40,COMPLETED
5321934,1,1,1704297241,1704297245,1704297282,37,COMPLETED
5321935,1,1,1704297241,1704297245,1704297280,35,COMPLETED
5321936,1,1,1704297241,1704297245,1704297280,35,COMPLETED
5321937,1,1,1704297241,1704297245,1704297284,39,COMPLETED
5321938,1,1,1704297241,1704297245,1704297281,36,COMPLETED
5321939,1,1,1704297241,1704297245,1704297280,35,COMPLETED
5321940,1,1,1704297242,1704297245,1704297283,38,COMPLETED
5321941,1,1,1704297242,1704297245,1704297283,38,COMPLETED
5321942,1,1,1704297242,1704297245,1704297281,36,COMPLETED
5321943,1,1,1704297242,1704297245,1704297286,41,COMPLETED
5321944,1,1,1704297242,1704297245,1704297286,41,COMPLETED
5321945,1,1,1704297242,1704297245,1704297280,35,COMPLETED
5321946,1,1,1704297242,1704297245,1704297282,37,COMPLETED
5321947,1,1,1704297242,1704297245,1704297283,38,COMPLETED
5321948,1,1,1704297242,1704297245,1704297284,39,COMPLETED
5321949,1,1,1704297242,1704297245,1704297279,34,COMPLETED
5321950,1,1,1704297242,1704297245,1704297280,35,COMPLETED
5321951,1,1,1704297242,1704297245,1704297281,36,COMPLETED
5321952,1,1,1704297242,1704297245,1704297281,36,COMPLETED
5321953,1,1,1704297244,1704297245,1704297281,36,COMPLETED
5321954,1,1,1704297244,1704297245,1704297281,36,COMPLETED
5321955,1,1,1704297244,1704297245,1704297282,37,COMPLETED
5321956,1,1,1704297244,1704297245,1704297283,38,COMPLETED
5321957,1,1,1704297244,1704297245,1704297283,38,COMPLETED
5321958,1,1,1704297244,1704297245,1704297281,36,COMPLETED
5321959,1,1,1704297244,1704297245,1704297283,38,COMPLETED
5321960,1,1,1704297244,1704297245,1704297281,36,COMPLETED
5321961,1,1,1704297244,1704297245,1704297283,38,COMPLETED
5321962,1,1,1704297244,1704297245,1704297282,37,COMPLETED
5321963,1,1,1704297244,1704297245,1704297281,36,COMPLETED
5321964,1,1,1704297244,1704297245,1704297283,38,COMPLETED
5321965,1,1,1704297245,1704297249,1704297289,40,COMPLETED
5321966,1,1,1704297245,1704297249,1704297298,49,COMPLETED
5321967,1,1,1704297245,1704297249,1704297297,48,COMPLETED
5321968,1,1,1704297245,1704297249,1704297298,49,COMPLETED
5321969,1,1,1704297245,1704297249,1704297298,49,COMPLETED
5321970,1,1,1704297245,1704297249,1704297299,50,COMPLETED
5321971,1,1,1704297245,1704297249,1704297298,49,COMPLETED
5321973,1,1,1704297245,1704297249,1704297300,51,COMPLETED
5321974,1,1,1704297245,1704297249,1704297300,51,COMPLETED
5321972,1,1,1704297245,1704297249,1704297419,170,COMPLETED
5321975,1,1,1704297246,1704297249,1704297300,51,COMPLETED
5321976,1,1,1704297246,1704297249,1704297300,51,COMPLETED
5321977,1,1,1704297246,1704297249,1704297299,50,COMPLETED
5321978,1,1,1704297246,1704297249,1704297300,51,COMPLETED
5321979,1,1,1704297246,1704297249,1704297296,47,COMPLETED
5321980,1,1,1704297246,1704297249,1704297301,52,COMPLETED
5321981,1,1,1704297247,1704297249,1704297301,52,COMPLETED
5321982,1,1,1704297247,1704297249,1704297297,48,COMPLETED
5321983,1,1,1704297247,1704297249,1704297301,52,COMPLETED
5321984,1,1,1704297247,1704297249,1704297297,48,COMPLETED
5321985,1,1,1704297247,1704297249,1704297297,48,COMPLETED
5321986,1,1,1704297247,1704297249,1704297299,50,COMPLETED
5321987,1,1,1704297247,1704297249,1704297299,50,COMPLETED
5321988,1,1,1704297247,1704297249,1704297299,50,COMPLETED
5321989,1,1,1704297247,1704297249,1704297298,49,COMPLETED
5321990,1,1,1704297247,1704297249,1704297299,50,COMPLETED
5321991,1,1,1704297247,1704297249,1704297299,50,COMPLETED
5321992,1,1,1704297247,1704297249,1704297299,50,COMPLETED
5321993,1,1,1704297247,1704297249,1704297299,50,COMPLETED
5321994,1,1,1704297247,1704297249,1704297299,50,COMPLETED
5321995,1,1,1704297248,1704297249,1704297299,50,COMPLETED
5321996,1,1,1704297248,1704297249,1704297298,49,COMPLETED
5321997,1,1,1704297248,1704297249,1704297297,48,COMPLETED
5321998,1,1,1704297248,1704297249,1704297299,50,COMPLETED
5321999,1,1,1704297248,1704297249,1704297297,48,COMPLETED
5322000,1,1,1704297248,1704297249,1704297297,48,COMPLETED
5322001,1,1,1704297248,1704297249,1704297296,47,COMPLETED
5322002,1,1,1704297248,1704297249,1704297297,48,COMPLETED
5322003,1,1,1704297248,1704297249,1704297299,50,COMPLETED
5322004,1,1,1704297249,1704297249,1704297297,48,COMPLETED
5322005,1,1,1704297249,1704297251,1704297298,47,COMPLETED
5322006,1,1,1704297249,1704297251,1704297296,45,COMPLETED
5322007,1,1,1704297249,1704297251,1704297297,46,COMPLETED
5322008,1,1,1704297249,1704297251,1704297297,46,COMPLETED
5322009,1,1,1704297249,1704297251,1704297299,48,COMPLETED
5322010,1,1,1704297250,1704297251,1704297298,47,COMPLETED
5322011,1,1,1704297250,1704297251,1704297297,46,COMPLETED
5322012,1,1,1704297250,1704297251,1704297296,45,COMPLETED
5322013,1,1,1704297250,1704297251,1704297297,46,COMPLETED
5322014,1,1,1704297250,1704297251,1704297306,55,COMPLETED
5322015,1,1,1704297250,1704297251,1704297296,45,COMPLETED
5322016,1,1,1704297250,1704297251,1704297299,48,COMPLETED
5322017,1,1,1704297250,1704297251,1704297299,48,COMPLETED
5322018,1,1,1704297250,1704297251,1704297298,47,COMPLETED
5322019,1,1,1704297250,1704297251,1704297297,46,COMPLETED
5322020,1,1,1704297250,1704297251,1704297299,48,COMPLETED
5322021,1,1,1704297250,1704297251,1704297297,46,COMPLETED
5322022,1,1,1704297250,1704297251,1704297297,46,COMPLETED
5322023,1,1,1704297250,1704297251,1704297298,47,COMPLETED
5322024,1,1,1704297250,1704297251,1704297300,49,COMPLETED
5322025,1,1,1704297251,1704297251,1704297299,48,COMPLETED
5322026,1,1,1704297251,1704297251,1704297296,45,COMPLETED
5322027,1,1,1704297251,1704297253,1704297297,44,COMPLETED
5322028,1,1,1704297251,1704297253,1704297297,44,COMPLETED
5322029,1,1,1704297251,1704297253,1704297298,45,COMPLETED
5322030,1,1,1704297251,1704297253,1704297298,45,COMPLETED
5322031,1,1,1704297251,1704297253,1704297299,46,COMPLETED
5322032,1,1,1704297251,1704297253,1704297300,47,COMPLETED
5322033,1,1,1704297251,1704297253,1704297297,44,COMPLETED
5322034,1,1,1704297251,1704297253,1704297296,43,COMPLETED
5322035,1,1,1704297252,1704297253,1704297297,44,COMPLETED
5322036,1,1,1704297252,1704297253,1704297290,37,COMPLETED
5322037,1,1,1704297252,1704297253,1704297289,36,COMPLETED
5322038,1,1,1704297252,1704297253,1704297293,40,COMPLETED
5322039,1,1,1704297252,1704297253,1704297289,36,COMPLETED
5322040,1,1,1704297252,1704297253,1704297298,45,COMPLETED
5322041,1,1,1704297252,1704297253,1704297297,44,COMPLETED
5322042,1,1,1704297252,1704297253,1704297290,37,COMPLETED
5322043,1,1,1704297252,1704297253,1704297288,35,COMPLETED
5322044,1,1,1704297252,1704297253,1704297289,36,COMPLETED
5322045,1,1,1704297253,1704297257,1704297289,32,COMPLETED
5322046,1,1,1704297253,1704297257,1704297288,31,COMPLETED
5322047,1,1,1704297253,1704297257,1704297288,31,COMPLETED
5322048,1,1,1704297253,1704297257,1704297289,32,COMPLETED
5322049,1,1,1704297253,1704297257,1704297289,32,COMPLETED
5322050,1,1,1704297253,1704297257,1704297293,36,COMPLETED
5322051,1,1,1704297253,1704297257,1704297288,31,COMPLETED
5322052,1,1,1704297254,1704297257,1704297288,31,COMPLETED
5322053,1,1,1704297254,1704297257,1704297288,31,COMPLETED
5322054,1,1,1704297264,1704297264,1704297314,50,COMPLETED
5322055,1,1,1704297265,1704297265,1704297313,48,COMPLETED
5322056,1,1,1704297265,1704297265,1704297314,49,COMPLETED
5322057,1,1,1704297265,1704297265,1704297314,49,COMPLETED
5322058,1,1,1704297265,1704297265,1704297315,50,COMPLETED
5322059,1,1,1704297265,1704297265,1704297316,51,COMPLETED
5322060,1,1,1704297280,1704297280,1704297317,37,COMPLETED
5322061,1,1,1704297280,1704297281,1704297317,36,COMPLETED
5322062,1,1,1704297281,1704297281,1704297317,36,COMPLETED
5322063,1,1,1704297281,1704297281,1704297318,37,COMPLETED
5322064,1,1,1704297282,1704297282,1704297317,35,COMPLETED
5322065,1,1,1704297282,1704297282,1704297317,35,COMPLETED
5322066,1,1,1704297282,1704297282,1704297318,36,COMPLETED
5322067,1,1,1704297282,1704297282,1704297317,35,COMPLETED
5322068,1,1,1704297282,1704297282,1704297317,35,COMPLETED
5322069,1,1,1704297282,1704297282,1704297317,35,COMPLETED
5322070,1,1,1704297282,1704297282,1704297317,35,COMPLETED
5322071,1,1,1704297282,1704297282,1704297318,36,COMPLETED
5322072,1,1,1704297282,1704297282,1704297318,36,COMPLETED
5322073,1,1,1704297283,1704297283,1704297317,34,COMPLETED
5322074,1,1,1704297283,1704297283,1704297316,33,COMPLETED
5322075,1,1,1704297283,1704297283,1704297316,33,COMPLETED
5322076,1,1,1704297283,1704297283,1704297318,35,COMPLETED
5322077,1,1,1704297283,1704297283,1704297318,35,COMPLETED
5322078,1,1,1704297283,1704297283,1704297313,30,COMPLETED
5322079,1,1,1704297283,1704297283,1704297314,31,COMPLETED
5322080,1,1,1704297283,1704297283,1704297315,32,COMPLETED
5322081,1,1,1704297283,1704297283,1704297314,31,COMPLETED
5322082,1,1,1704297283,1704297283,1704297314,31,COMPLETED
5322083,1,1,1704297283,1704297283,1704297315,32,COMPLETED
5322084,1,1,1704297283,1704297283,1704297314,31,COMPLETED
5322085,1,1,1704297284,1704297284,1704297314,30,COMPLETED
5322086,1,1,1704297284,1704297284,1704297314,30,COMPLETED
5322087,1,1,1704297284,1704297284,1704297315,31,COMPLETED
5322088,1,1,1704297284,1704297284,1704297313,29,COMPLETED
5322089,1,1,1704297284,1704297284,1704297315,31,COMPLETED
5322090,1,1,1704297284,1704297284,1704297315,31,COMPLETED
5322091,1,1,1704297284,1704297284,1704297313,29,COMPLETED
5322092,1,1,1704297284,1704297284,1704297314,30,COMPLETED
5322093,1,1,1704297297,1704297297,1704297346,49,COMPLETED
5322094,1,1,1704297297,1704297297,1704297346,49,COMPLETED
5322095,1,1,1704297297,1704297297,1704297346,49,COMPLETED
5322096,1,1,1704297297,1704297297,1704297346,49,COMPLETED
5322097,1,1,1704297297,1704297297,1704297346,49,COMPLETED
5322098,1,1,1704297297,1704297297,1704297349,52,COMPLETED
5322099,1,1,1704297297,1704297298,1704297347,49,COMPLETED
5322100,1,1,1704297297,1704297298,1704297346,48,COMPLETED
5322101,1,1,1704297297,1704297298,1704297349,51,COMPLETED
5322102,1,1,1704297298,1704297298,1704297346,48,COMPLETED
5322103,1,1,1704297298,1704297298,1704297346,48,COMPLETED
5322104,1,1,1704297298,1704297298,1704297346,48,COMPLETED
5322105,1,1,1704297298,1704297298,1704297346,48,COMPLETED
5322106,1,1,1704297298,1704297298,1704297346,48,COMPLETED
5322107,1,1,1704297298,1704297298,1704297346,48,COMPLETED
5322108,1,1,1704297298,1704297298,1704297346,48,COMPLETED
5322109,1,1,1704297298,1704297298,1704297346,48,COMPLETED
5322110,1,1,1704297298,1704297298,1704297346,48,COMPLETED
5322111,1,1,1704297298,1704297298,1704297346,48,COMPLETED
5322112,1,1,1704297299,1704297299,1704297346,47,COMPLETED
5322113,1,1,1704297299,1704297299,1704297346,47,COMPLETED
5322114,1,1,1704297299,1704297299,1704297346,47,COMPLETED
5322115,1,1,1704297299,1704297299,1704297346,47,COMPLETED
5322116,1,1,1704297299,1704297299,1704297346,47,COMPLETED
5322117,1,1,1704297299,1704297299,1704297346,47,COMPLETED
5322118,1,1,1704297299,1704297299,1704297346,47,COMPLETED
5322119,1,1,1704297299,1704297299,1704297346,47,COMPLETED
5322120,1,1,1704297299,1704297299,1704297346,47,COMPLETED
5322121,1,1,1704297299,1704297299,1704297346,47,COMPLETED
5322122,1,1,1704297300,1704297300,1704297346,46,COMPLETED
5322123,1,1,1704297300,1704297300,1704297346,46,COMPLETED
5322124,1,1,1704297300,1704297300,1704297346,46,COMPLETED
5322125,1,1,1704297300,1704297300,1704297346,46,COMPLETED
5322126,1,1,1704297300,1704297300,1704297346,46,COMPLETED
5322127,1,1,1704297300,1704297300,1704297346,46,COMPLETED
5322128,1,1,1704297300,1704297300,1704297346,46,COMPLETED
5322129,1,1,1704297300,1704297300,1704297346,46,COMPLETED
5322130,1,1,1704297300,1704297300,1704297346,46,COMPLETED
5322131,1,1,1704297300,1704297300,1704297346,46,COMPLETED
5322132,1,1,1704297301,1704297301,1704297346,45,COMPLETED
5322133,1,1,1704297301,1704297301,1704297346,45,COMPLETED
5322134,1,1,1704297301,1704297301,1704297346,45,COMPLETED
5322135,1,1,1704297301,1704297301,1704297346,45,COMPLETED
5322136,1,1,1704297301,1704297301,1704297346,45,COMPLETED
5322137,1,1,1704297301,1704297301,1704297346,45,COMPLETED
5322138,1,1,1704297301,1704297301,1704297346,45,COMPLETED
5322139,1,1,1704297301,1704297301,1704297346,45,COMPLETED
5322140,1,1,1704297301,1704297301,1704297346,45,COMPLETED
5322141,1,1,1704297301,1704297301,1704297346,45,COMPLETED
5322142,1,1,1704297302,1704297302,1704297349,47,COMPLETED
5322143,1,1,1704297302,1704297302,1704297350,48,COMPLETED
5322144,1,1,1704297302,1704297302,1704297349,47,COMPLETED
5322145,1,1,1704297302,1704297302,1704297348,46,COMPLETED
5322146,1,1,1704297302,1704297302,1704297348,46,COMPLETED
5322147,1,1,1704297302,1704297302,1704297351,49,COMPLETED
5322148,1,1,1704297302,1704297302,1704297351,49,COMPLETED
5322149,1,1,1704297302,1704297302,1704297349,47,COMPLETED
5322150,1,1,1704297302,1704297302,1704297350,48,COMPLETED
5322151,1,1,1704297302,1704297302,1704297351,49,COMPLETED
5322152,1,1,1704297303,1704297305,1704297349,44,COMPLETED
5322153,1,1,1704297303,1704297305,1704297348,43,COMPLETED
5322154,1,1,1704297303,1704297305,1704297347,42,COMPLETED
5322155,1,1,1704297303,1704297305,1704297349,44,COMPLETED
5322156,1,1,1704297303,1704297305,1704297348,43,COMPLETED
5322157,1,1,1704297303,1704297305,1704297349,44,COMPLETED
5322158,1,1,1704297303,1704297305,1704297346,41,COMPLETED
5322159,1,1,1704297303,1704297305,1704297349,44,COMPLETED
5322160,1,1,1704297303,1704297305,1704297349,44,COMPLETED
5322161,1,1,1704297303,1704297305,1704297347,42,COMPLETED
5322162,1,1,1704297304,1704297305,1704297349,44,COMPLETED
5322163,1,1,1704297304,1704297305,1704297348,43,COMPLETED
5322164,1,1,1704297304,1704297305,1704297347,42,COMPLETED
5322165,1,1,1704297304,1704297305,1704297349,44,COMPLETED
5322166,1,1,1704297304,1704297305,1704297346,41,COMPLETED
5322167,1,1,1704297304,1704297305,1704297349,44,COMPLETED
5322168,1,1,1704297304,1704297305,1704297350,45,COMPLETED
5322169,1,1,1704297304,1704297305,1704297348,43,COMPLETED
5322170,1,1,1704297304,1704297305,1704297350,45,COMPLETED
5322171,1,1,1704297304,1704297305,1704297350,45,COMPLETED
5322172,1,1,1704297305,1704297305,1704297347,42,COMPLETED
5322173,1,1,1704297305,1704297305,1704297346,41,COMPLETED
5322174,1,1,1704297305,1704297305,1704297347,42,COMPLETED
5322175,1,1,1704297305,1704297305,1704297347,42,COMPLETED
5322176,1,1,1704297305,1704297305,1704297347,42,COMPLETED
5322177,1,1,1704297305,1704297307,1704297350,43,COMPLETED
5322178,1,1,1704297305,1704297307,1704297352,45,COMPLETED
5322179,1,1,1704297305,1704297307,1704297346,39,COMPLETED
5322180,1,1,1704297305,1704297307,1704297347,40,COMPLETED
5322181,1,1,1704297306,1704297307,1704297346,39,COMPLETED
5322182,1,1,1704297306,1704297307,1704297348,41,COMPLETED
5322183,1,1,1704297306,1704297307,1704297349,42,COMPLETED
5322184,1,1,1704297306,1704297307,1704297349,42,COMPLETED
5322185,1,1,1704297306,1704297307,1704297349,42,COMPLETED
5322186,1,1,1704297306,1704297307,1704297349,42,COMPLETED
5322187,1,1,1704297306,1704297307,1704297347,40,COMPLETED
5322188,1,1,1704297306,1704297307,1704297348,41,COMPLETED
5322189,1,1,1704297306,1704297307,1704297350,43,COMPLETED
5322190,1,1,1704297306,1704297307,1704297348,41,COMPLETED
5322191,1,1,1704297307,1704297307,1704297349,42,COMPLETED
5322192,1,1,1704297307,1704297307,1704297349,42,COMPLETED
5322193,1,1,1704297307,1704297307,1704297347,40,COMPLETED
5322194,1,1,1704297307,1704297307,1704297349,42,COMPLETED
5322195,1,1,1704297307,1704297307,1704297349,42,COMPLETED
5322196,1,1,1704297307,1704297309,1704297347,38,COMPLETED
5322197,1,1,1704297307,1704297309,1704297350,41,COMPLETED
5322198,1,1,1704297307,1704297309,1704297348,39,COMPLETED
5322199,1,1,1704297307,1704297309,1704297351,42,COMPLETED
5322200,1,1,1704297307,1704297309,1704297349,40,COMPLETED
5322201,1,1,1704297308,1704297309,1704297351,42,COMPLETED
5322202,1,1,1704297308,1704297309,1704297350,41,COMPLETED
5322203,1,1,1704297308,1704297309,1704297346,37,COMPLETED
5322204,1,1,1704297308,1704297309,1704297349,40,COMPLETED
5322205,1,1,1704297308,1704297309,1704297349,40,COMPLETED
5322206,1,1,1704297308,1704297309,1704297350,41,COMPLETED
5322207,1,1,1704297308,1704297309,1704297350,41,COMPLETED
5322208,1,1,1704297308,1704297309,1704297350,41,COMPLETED
5322209,1,1,1704297308,1704297309,1704297351,42,COMPLETED
5322210,1,1,1704297308,1704297309,1704297347,38,COMPLETED
5322211,1,1,1704297309,1704297309,1704297347,38,COMPLETED
5322212,1,1,1704297309,1704297309,1704297346,37,COMPLETED
5322213,1,1,1704297309,1704297309,1704297346,37,COMPLETED
5322214,1,1,1704297309,1704297309,1704297346,37,COMPLETED
5322215,1,1,1704297309,1704297309,1704297346,37,COMPLETED
5322216,1,1,1704297309,1704297309,1704297346,37,COMPLETED
5322217,1,1,1704297309,1704297309,1704297346,37,COMPLETED
5322218,36,1,1704297310,1704297313,1704297901,588,FAILED
5322219,1,1,1704297446,1704297446,1704297498,52,COMPLETED
5322220,1,1,1704297446,1704297446,1704297502,56,COMPLETED
5322221,1,1,1704297446,1704297446,1704297498,52,COMPLETED
5322222,1,1,1704297446,1704297446,1704297502,56,COMPLETED
5322223,1,1,1704297446,1704297446,1704297498,52,COMPLETED
5322224,1,1,1704297446,1704297446,1704297498,52,COMPLETED
5322225,1,1,1704297446,1704297446,1704297498,52,COMPLETED
5322226,1,1,1704297446,1704297446,1704297498,52,COMPLETED
5322227,1,1,1704297446,1704297446,1704297499,53,COMPLETED
5322228,1,1,1704297446,1704297446,1704297498,52,COMPLETED
5322229,1,1,1704297446,1704297446,1704297499,53,COMPLETED
5322230,1,1,1704297446,1704297446,1704297498,52,COMPLETED
5322231,1,1,1704297446,1704297446,1704297498,52,COMPLETED
5322232,1,1,1704297446,1704297446,1704297498,52,COMPLETED
5322233,1,1,1704297446,1704297446,1704297507,61,COMPLETED
5322234,1,1,1704297446,1704297446,1704297498,52,COMPLETED
5322235,1,1,1704297446,1704297446,1704297498,52,COMPLETED
5322236,1,1,1704297446,1704297446,1704297498,52,COMPLETED
5322237,1,1,1704297446,1704297447,1704297498,51,COMPLETED
5322238,1,1,1704297446,1704297447,1704297498,51,COMPLETED
5322239,1,1,1704297446,1704297447,1704297502,55,COMPLETED
5322240,1,1,1704297446,1704297447,1704297498,51,COMPLETED
5322241,1,1,1704297447,1704297447,1704297498,51,COMPLETED
5322242,1,1,1704297447,1704297447,1704297498,51,COMPLETED
5322243,1,1,1704297447,1704297447,1704297498,51,COMPLETED
5322244,1,1,1704297447,1704297447,1704297505,58,COMPLETED
5322245,1,1,1704297447,1704297447,1704297498,51,COMPLETED
5322246,1,1,1704297447,1704297447,1704297498,51,COMPLETED
5322247,1,1,1704297447,1704297447,1704297498,51,COMPLETED
5322248,1,1,1704297447,1704297447,1704297499,52,COMPLETED
5322249,1,1,1704297447,1704297447,1704297498,51,COMPLETED
5322250,1,1,1704297447,1704297447,1704297503,56,COMPLETED
5322251,1,1,1704297447,1704297447,1704297498,51,COMPLETED
5322252,1,1,1704297447,1704297447,1704297507,60,COMPLETED
5322253,1,1,1704297447,1704297448,1704297498,50,COMPLETED
5322254,1,1,1704297447,1704297448,1704297498,50,COMPLETED
5322255,1,1,1704297447,1704297448,1704297498,50,COMPLETED
5322256,1,1,1704297447,1704297448,1704297502,54,COMPLETED
5322257,1,1,1704297447,1704297448,1704297498,50,COMPLETED
5322258,1,1,1704297447,1704297448,1704297501,53,COMPLETED
5322259,1,1,1704297447,1704297448,1704297505,57,COMPLETED
5322260,1,1,1704297447,1704297448,1704297498,50,COMPLETED
5322261,1,1,1704297447,1704297448,1704297498,50,COMPLETED
5322262,1,1,1704297447,1704297448,1704297499,51,COMPLETED
5322263,1,1,1704297447,1704297448,1704297498,50,COMPLETED
5322264,1,1,1704297447,1704297448,1704297498,50,COMPLETED
5322265,1,1,1704297447,1704297448,1704297499,51,COMPLETED
5322266,1,1,1704297447,1704297448,1704297499,51,COMPLETED
5322267,1,1,1704297447,1704297448,1704297499,51,COMPLETED
5322268,1,1,1704297447,1704297448,1704297504,56,COMPLETED
5322269,1,1,1704297447,1704297448,1704297502,54,COMPLETED
5322270,1,1,1704297447,1704297448,1704297502,54,COMPLETED
5322271,1,1,1704297447,1704297448,1704297500,52,COMPLETED
5322272,1,1,1704297447,1704297448,1704297498,50,COMPLETED
5322273,1,1,1704297447,1704297448,1704297499,51,COMPLETED
5322274,1,1,1704297447,1704297448,1704297499,51,COMPLETED
5322275,1,1,1704297447,1704297448,1704297498,50,COMPLETED
5322276,1,1,1704297447,1704297448,1704297498,50,COMPLETED
5322277,1,1,1704297447,1704297448,1704297502,54,COMPLETED
5322279,1,1,1704297447,1704297448,1704297498,50,COMPLETED
5322278,1,1,1704297447,1704297448,1704297702,254,COMPLETED
5322280,1,1,1704297448,1704297450,1704297498,48,COMPLETED
5322281,1,1,1704297448,1704297450,1704297498,48,COMPLETED
5322282,1,1,1704297448,1704297450,1704297503,53,COMPLETED
5322283,1,1,1704297448,1704297450,1704297505,55,COMPLETED
5322284,1,1,1704297448,1704297450,1704297499,49,COMPLETED
5322285,1,1,1704297448,1704297450,1704297498,48,COMPLETED
5322286,1,1,1704297448,1704297450,1704297498,48,COMPLETED
5322287,1,1,1704297448,1704297450,1704297503,53,COMPLETED
5322288,1,1,1704297448,1704297450,1704297498,48,COMPLETED
5322289,1,1,1704297448,1704297450,1704297501,51,COMPLETED
5322290,1,1,1704297448,1704297450,1704297503,53,COMPLETED
5322291,1,1,1704297448,1704297450,1704297498,48,COMPLETED
5322292,1,1,1704297448,1704297450,1704297499,49,COMPLETED
5322293,1,1,1704297448,1704297450,1704297498,48,COMPLETED
5322294,1,1,1704297448,1704297450,1704297503,53,COMPLETED
5322295,1,1,1704297448,1704297450,1704297498,48,COMPLETED
5322296,1,1,1704297448,1704297450,1704297499,49,COMPLETED
5322297,1,1,1704297449,1704297450,1704297499,49,COMPLETED
5322298,1,1,1704297449,1704297450,1704297505,55,COMPLETED
5322299,1,1,1704297449,1704297450,1704297498,48,COMPLETED
5322300,1,1,1704297449,1704297450,1704297498,48,COMPLETED
5322301,1,1,1704297449,1704297450,1704297498,48,COMPLETED
5322302,1,1,1704297449,1704297450,1704297502,52,COMPLETED
5322303,1,1,1704297449,1704297450,1704297498,48,COMPLETED
5322304,1,1,1704297449,1704297450,1704297498,48,COMPLETED
5322305,1,1,1704297449,1704297450,1704297499,49,COMPLETED
5322306,1,1,1704297449,1704297450,1704297501,51,COMPLETED
5322307,1,1,1704297449,1704297450,1704297505,55,COMPLETED
5322308,1,1,1704297449,1704297450,1704297502,52,COMPLETED
5322309,1,1,1704297449,1704297450,1704297498,48,COMPLETED
5322310,1,1,1704297449,1704297450,1704297498,48,COMPLETED
5322311,1,1,1704297449,1704297450,1704297498,48,COMPLETED
5322312,1,1,1704297449,1704297450,1704297498,48,COMPLETED
5322313,1,1,1704297449,1704297450,1704297502,52,COMPLETED
5322314,1,1,1704297449,1704297450,1704297502,52,COMPLETED
5322315,1,1,1704297449,1704297450,1704297505,55,COMPLETED
5322316,1,1,1704297449,1704297450,1704297498,48,COMPLETED
5322317,1,1,1704297449,1704297450,1704297498,48,COMPLETED
5322318,1,1,1704297449,1704297450,1704297498,48,COMPLETED
5322319,1,1,1704297449,1704297450,1704297498,48,COMPLETED
5322320,1,1,1704297449,1704297450,1704297498,48,COMPLETED
5322321,1,1,1704297449,1704297450,1704297498,48,COMPLETED
5322322,1,1,1704297449,1704297450,1704297502,52,COMPLETED
5322323,1,1,1704297449,1704297450,1704297498,48,COMPLETED
5322324,1,1,1704297449,1704297450,1704297499,49,COMPLETED
5322325,1,1,1704297449,1704297450,1704297499,49,COMPLETED
5322326,1,1,1704297449,1704297450,1704297502,52,COMPLETED
5322327,1,1,1704297449,1704297450,1704297498,48,COMPLETED
5322328,1,1,1704297449,1704297450,1704297499,49,COMPLETED
5322329,1,1,1704297449,1704297450,1704297498,48,COMPLETED
5322330,1,1,1704297449,1704297450,1704297498,48,COMPLETED
5322331,1,1,1704297449,1704297450,1704297498,48,COMPLETED
5322332,1,1,1704297449,1704297450,1704297498,48,COMPLETED
5322333,1,1,1704297449,1704297450,1704297498,48,COMPLETED
5322334,1,1,1704297449,1704297450,1704297506,56,COMPLETED
5322335,1,1,1704297449,1704297450,1704297498,48,COMPLETED
5322336,1,1,1704297449,1704297450,1704297498,48,COMPLETED
5322337,1,1,1704297449,1704297450,1704297498,48,COMPLETED
5322338,1,1,1704297449,1704297450,1704297498,48,COMPLETED
5322339,1,1,1704297449,1704297450,1704297499,49,COMPLETED
5322340,1,1,1704297449,1704297450,1704297498,48,COMPLETED
5322341,1,1,1704297449,1704297450,1704297498,48,COMPLETED
5322342,1,1,1704297449,1704297450,1704297498,48,COMPLETED
5322343,1,1,1704297449,1704297450,1704297502,52,COMPLETED
5322344,1,1,1704297449,1704297450,1704297498,48,COMPLETED
5322345,1,1,1704297449,1704297450,1704297498,48,COMPLETED
5322346,1,1,1704297449,1704297450,1704297498,48,COMPLETED
5322347,1,1,1704297449,1704297450,1704297501,51,COMPLETED
5322348,1,1,1704297449,1704297450,1704297499,49,COMPLETED
5322349,1,1,1704297449,1704297450,1704297498,48,COMPLETED
5322350,1,1,1704297449,1704297450,1704297502,52,COMPLETED
5322351,1,1,1704297449,1704297450,1704297502,52,COMPLETED
5322352,1,1,1704297449,1704297450,1704297499,49,COMPLETED
5322353,1,1,1704297449,1704297450,1704297507,57,COMPLETED
5322354,1,1,1704297449,1704297450,1704297499,49,COMPLETED
5322355,1,1,1704297449,1704297450,1704297500,50,COMPLETED
5322356,1,1,1704297449,1704297450,1704297499,49,COMPLETED
5322357,1,1,1704297449,1704297450,1704297498,48,COMPLETED
5322358,1,1,1704297449,1704297450,1704297502,52,COMPLETED
5322359,1,1,1704297449,1704297450,1704297502,52,COMPLETED
5322360,1,1,1704297449,1704297450,1704297498,48,COMPLETED
5322361,1,1,1704297449,1704297450,1704297499,49,COMPLETED
5322362,1,1,1704297449,1704297450,1704297498,48,COMPLETED
5322363,1,1,1704297450,1704297450,1704297498,48,COMPLETED
5322364,1,1,1704297450,1704297450,1704297498,48,COMPLETED
5322365,1,1,1704297450,1704297450,1704297498,48,COMPLETED
5322366,1,1,1704297450,1704297450,1704297498,48,COMPLETED
5322367,1,1,1704297450,1704297450,1704297498,48,COMPLETED
5322368,1,1,1704297450,1704297450,1704297501,51,COMPLETED
5322369,1,1,1704297450,1704297450,1704297498,48,COMPLETED
5322370,1,1,1704297450,1704297450,1704297499,49,COMPLETED
5322371,1,1,1704297450,1704297450,1704297502,52,COMPLETED
5322372,1,1,1704297450,1704297450,1704297498,48,COMPLETED
5322373,1,1,1704297450,1704297454,1704297504,50,COMPLETED
5322374,1,1,1704297450,1704297454,1704297498,44,COMPLETED
5322375,1,1,1704297450,1704297454,1704297498,44,COMPLETED
5322376,1,1,1704297450,1704297454,1704297505,51,COMPLETED
5322377,1,1,1704297451,1704297454,1704297502,48,COMPLETED
5322378,1,1,1704297451,1704297454,1704297498,44,COMPLETED
5322379,1,1,1704297451,1704297454,1704297498,44,COMPLETED
5322380,1,1,1704297451,1704297454,1704297499,45,COMPLETED
5322381,1,1,1704297451,1704297454,1704297498,44,COMPLETED
5322382,1,1,1704297451,1704297454,1704297502,48,COMPLETED
5322383,1,1,1704297451,1704297454,1704297501,47,COMPLETED
5322384,1,1,1704297451,1704297454,1704297499,45,COMPLETED
5322385,1,1,1704297451,1704297454,1704297498,44,COMPLETED
5322386,1,1,1704297451,1704297454,1704297499,45,COMPLETED
5322387,1,1,1704297451,1704297454,1704297500,46,COMPLETED
5322388,1,1,1704297451,1704297454,1704297498,44,COMPLETED
5322389,1,1,1704297451,1704297454,1704297498,44,COMPLETED
5322390,1,1,1704297451,1704297454,1704297502,48,COMPLETED
5322391,1,1,1704297451,1704297454,1704297501,47,COMPLETED
5322392,1,1,1704297451,1704297454,1704297498,44,COMPLETED
5322393,1,1,1704297451,1704297454,1704297498,44,COMPLETED
5322394,1,1,1704297451,1704297454,1704297498,44,COMPLETED
5322395,1,1,1704297451,1704297454,1704297498,44,COMPLETED
5322396,1,1,1704297451,1704297454,1704297498,44,COMPLETED
5322397,1,1,1704297451,1704297454,1704297498,44,COMPLETED
5322398,1,1,1704297451,1704297454,1704297498,44,COMPLETED
5322399,1,1,1704297451,1704297454,1704297498,44,COMPLETED
5322400,1,1,1704297451,1704297454,1704297498,44,COMPLETED
5322401,1,1,1704297451,1704297454,1704297498,44,COMPLETED
5322402,1,1,1704297451,1704297454,1704297499,45,COMPLETED
5322403,1,1,1704297451,1704297454,1704297499,45,COMPLETED
5322404,1,1,1704297451,1704297454,1704297498,44,COMPLETED
5322405,1,1,1704297451,1704297454,1704297499,45,COMPLETED
5322406,1,1,1704297451,1704297454,1704297499,45,COMPLETED
5322407,1,1,1704297451,1704297454,1704297498,44,COMPLETED
5322408,1,1,1704297451,1704297454,1704297498,44,COMPLETED
5322409,1,1,1704297451,1704297454,1704297507,53,COMPLETED
5322410,1,1,1704297451,1704297454,1704297498,44,COMPLETED
5322411,1,1,1704297451,1704297454,1704297502,48,COMPLETED
5322412,1,1,1704297452,1704297454,1704297498,44,COMPLETED
5322413,1,1,1704297452,1704297454,1704297498,44,COMPLETED
5322414,1,1,1704297452,1704297454,1704297498,44,COMPLETED
5322415,1,1,1704297452,1704297454,1704297499,45,COMPLETED
5322416,1,1,1704297452,1704297454,1704297498,44,COMPLETED
5322417,1,1,1704297452,1704297454,1704297501,47,COMPLETED
5322418,1,1,1704297452,1704297454,1704297498,44,COMPLETED
5322419,1,1,1704297499,1704297499,1704297545,46,COMPLETED
5322420,1,1,1704297499,1704297499,1704297540,41,COMPLETED
5322421,1,1,1704297499,1704297499,1704297538,39,COMPLETED
5322422,1,1,1704297499,1704297499,1704297538,39,COMPLETED
5322423,1,1,1704297499,1704297500,1704297541,41,COMPLETED
5322424,1,1,1704297500,1704297500,1704297540,40,COMPLETED
5322425,1,1,1704297500,1704297501,1704297540,39,COMPLETED
5322426,1,1,1704297501,1704297501,1704297538,37,COMPLETED
5322427,1,1,1704297501,1704297502,1704297545,43,COMPLETED
5322428,1,1,1704297502,1704297502,1704297539,37,COMPLETED
5322429,1,1,1704297502,1704297502,1704297541,39,COMPLETED
5322430,1,1,1704297502,1704297502,1704297539,37,COMPLETED
5322431,1,1,1704297502,1704297502,1704297539,37,COMPLETED
5322432,1,1,1704297502,1704297502,1704297539,37,COMPLETED
5322433,1,1,1704297502,1704297502,1704297541,39,COMPLETED
5322434,1,1,1704297502,1704297502,1704297539,37,COMPLETED
5322435,1,1,1704297502,1704297502,1704297540,38,COMPLETED
5322436,1,1,1704297502,1704297502,1704297539,37,COMPLETED
5322437,1,1,1704297503,1704297503,1704297538,35,COMPLETED
5322438,1,1,1704297503,1704297503,1704297541,38,COMPLETED
5322439,1,1,1704297503,1704297503,1704297538,35,COMPLETED
5322440,1,1,1704297503,1704297503,1704297539,36,COMPLETED
5322441,1,1,1704297503,1704297503,1704297540,37,COMPLETED
5322442,1,1,1704297503,1704297503,1704297539,36,COMPLETED
5322443,1,1,1704297503,1704297503,1704297539,36,COMPLETED
5322444,1,1,1704297503,1704297503,1704297538,35,COMPLETED
5322445,1,1,1704297503,1704297503,1704297539,36,COMPLETED
5322446,1,1,1704297503,1704297503,1704297540,37,COMPLETED
5322447,1,1,1704297504,1704297504,1704297538,34,COMPLETED
5322448,1,1,1704297504,1704297504,1704297539,35,COMPLETED
5322449,1,1,1704297512,1704297512,1704297530,18,COMPLETED
5322450,1,1,1704297513,1704297516,1704297551,35,COMPLETED
5322451,1,1,1704297513,1704297516,1704297552,36,COMPLETED
5322452,1,1,1704297513,1704297516,1704297551,35,COMPLETED
5322453,1,1,1704297513,1704297516,1704297551,35,COMPLETED
5322454,1,1,1704297513,1704297516,1704297551,35,COMPLETED
5322455,1,1,1704297513,1704297516,1704297554,38,COMPLETED
5322456,1,1,1704297513,1704297516,1704297552,36,COMPLETED
5322457,1,1,1704297513,1704297516,1704297551,35,COMPLETED
5322458,1,1,1704297513,1704297516,1704297552,36,COMPLETED
5322459,1,1,1704297513,1704297516,1704297553,37,COMPLETED
5322460,1,1,1704297514,1704297516,1704297552,36,COMPLETED
5322461,1,1,1704297514,1704297516,1704297552,36,COMPLETED
5322462,1,1,1704297514,1704297516,1704297551,35,COMPLETED
5322463,1,1,1704297514,1704297516,1704297551,35,COMPLETED
5322464,1,1,1704297514,1704297516,1704297551,35,COMPLETED
5322465,1,1,1704297514,1704297516,1704297551,35,COMPLETED
5322466,1,1,1704297514,1704297516,1704297552,36,COMPLETED
5322467,1,1,1704297514,1704297516,1704297553,37,COMPLETED
5322468,1,1,1704297514,1704297516,1704297552,36,COMPLETED
5322469,1,1,1704297514,1704297516,1704297553,37,COMPLETED
5322470,1,1,1704297515,1704297516,1704297551,35,COMPLETED
5322471,1,1,1704297515,1704297516,1704297552,36,COMPLETED
5322472,1,1,1704297515,1704297516,1704297551,35,COMPLETED
5322473,1,1,1704297515,1704297516,1704297552,36,COMPLETED
5322474,1,1,1704297515,1704297516,1704297551,35,COMPLETED
5322475,1,1,1704297515,1704297516,1704297551,35,COMPLETED
5322476,1,1,1704297515,1704297516,1704297551,35,COMPLETED
5322477,1,1,1704297515,1704297516,1704297552,36,COMPLETED
5322478,1,1,1704297515,1704297516,1704297551,35,COMPLETED
5322479,1,1,1704297515,1704297516,1704297553,37,COMPLETED
5322480,1,1,1704297516,1704297516,1704297553,37,COMPLETED
5322481,1,1,1704297516,1704297516,1704297553,37,COMPLETED
5322482,1,1,1704297516,1704297516,1704297551,35,COMPLETED
5322483,1,1,1704297516,1704297516,1704297551,35,COMPLETED
5322484,1,1,1704297516,1704297516,1704297538,22,COMPLETED
5322485,1,1,1704297516,1704297516,1704297538,22,COMPLETED
5322486,1,1,1704297516,1704297516,1704297539,23,COMPLETED
5322487,1,1,1704297516,1704297516,1704297538,22,COMPLETED
5322488,1,1,1704297516,1704297520,1704297568,48,COMPLETED
5322489,1,1,1704297516,1704297520,1704297565,45,COMPLETED
5322490,1,1,1704297517,1704297520,1704297570,50,COMPLETED
5322491,1,1,1704297517,1704297520,1704297564,44,COMPLETED
5322492,1,1,1704297517,1704297520,1704297564,44,COMPLETED
5322493,1,1,1704297517,1704297520,1704297569,49,COMPLETED
5322494,1,1,1704297517,1704297520,1704297571,51,COMPLETED
5322495,1,1,1704297517,1704297520,1704297567,47,COMPLETED
5322496,1,1,1704297517,1704297520,1704297567,47,COMPLETED
5322497,1,1,1704297517,1704297520,1704297564,44,COMPLETED
5322498,1,1,1704297517,1704297520,1704297568,48,COMPLETED
5322499,1,1,1704297517,1704297520,1704297566,46,COMPLETED
5322500,1,1,1704297518,1704297520,1704297567,47,COMPLETED
5322501,1,1,1704297518,1704297520,1704297567,47,COMPLETED
5322502,1,1,1704297518,1704297520,1704297568,48,COMPLETED
5322503,1,1,1704297518,1704297520,1704297567,47,COMPLETED
5322504,1,1,1704297518,1704297520,1704297566,46,COMPLETED
5322505,1,1,1704297518,1704297520,1704297564,44,COMPLETED
5322506,1,1,1704297518,1704297520,1704297569,49,COMPLETED
5322507,1,1,1704297518,1704297520,1704297564,44,COMPLETED
5322508,1,1,1704297518,1704297520,1704297567,47,COMPLETED
5322509,1,1,1704297519,1704297520,1704297568,48,COMPLETED
5322510,1,1,1704297519,1704297520,1704297565,45,COMPLETED
5322511,1,1,1704297519,1704297520,1704297564,44,COMPLETED
5322512,1,1,1704297519,1704297520,1704297566,46,COMPLETED
5322513,1,1,1704297519,1704297520,1704297567,47,COMPLETED
5322514,1,1,1704297519,1704297520,1704297567,47,COMPLETED
5322515,1,1,1704297519,1704297520,1704297566,46,COMPLETED
5322516,1,1,1704297519,1704297520,1704297568,48,COMPLETED
5322517,1,1,1704297519,1704297520,1704297567,47,COMPLETED
5322518,1,1,1704297519,1704297520,1704297564,44,COMPLETED
5322519,1,1,1704297520,1704297520,1704297565,45,COMPLETED
5322520,1,1,1704297520,1704297520,1704297567,47,COMPLETED
5322521,1,1,1704297520,1704297520,1704297571,51,COMPLETED
5322522,1,1,1704297520,1704297520,1704297569,49,COMPLETED
5322523,1,1,1704297520,1704297520,1704297569,49,COMPLETED
5322524,1,1,1704297520,1704297520,1704297569,49,COMPLETED
5322525,1,1,1704297520,1704297520,1704297568,48,COMPLETED
5322526,1,1,1704297520,1704297520,1704297567,47,COMPLETED
5322527,1,1,1704297520,1704297520,1704297567,47,COMPLETED
5322528,1,1,1704297520,1704297520,1704297572,52,COMPLETED
5322529,1,1,1704297521,1704297524,1704297567,43,COMPLETED
5322530,1,1,1704297521,1704297524,1704297579,55,COMPLETED
5322531,1,1,1704297521,1704297524,1704297563,39,COMPLETED
5322532,1,1,1704297521,1704297524,1704297581,57,COMPLETED
5322533,1,1,1704297521,1704297524,1704297565,41,COMPLETED
5322534,1,1,1704297521,1704297524,1704297563,39,COMPLETED
5322535,1,1,1704297521,1704297524,1704297567,43,COMPLETED
5322536,1,1,1704297521,1704297524,1704297571,47,COMPLETED
5322537,1,1,1704297521,1704297524,1704297572,48,COMPLETED
5322538,1,1,1704297521,1704297524,1704297565,41,COMPLETED
5322539,1,1,1704297522,1704297524,1704297565,41,COMPLETED
5322540,1,1,1704297522,1704297524,1704297565,41,COMPLETED
5322541,1,1,1704297522,1704297524,1704297571,47,COMPLETED
5322542,1,1,1704297522,1704297524,1704297570,46,COMPLETED
5322543,1,1,1704297522,1704297524,1704297569,45,COMPLETED
5322544,1,1,1704297522,1704297524,1704297569,45,COMPLETED
5322545,1,1,1704297522,1704297524,1704297567,43,COMPLETED
5322546,1,1,1704297522,1704297524,1704297564,40,COMPLETED
5322547,1,1,1704297522,1704297524,1704297565,41,COMPLETED
5322548,1,1,1704297522,1704297524,1704297567,43,COMPLETED
5322549,1,1,1704297523,1704297524,1704297565,41,COMPLETED
5322550,1,1,1704297523,1704297524,1704297567,43,COMPLETED
5322551,1,1,1704297523,1704297524,1704297566,42,COMPLETED
5322552,1,1,1704297523,1704297524,1704297568,44,COMPLETED
5322553,1,1,1704297523,1704297524,1704297566,42,COMPLETED
5322554,1,1,1704297523,1704297524,1704297572,48,COMPLETED
5322555,1,1,1704297523,1704297524,1704297567,43,COMPLETED
5322556,1,1,1704297523,1704297524,1704297557,33,COMPLETED
5322557,1,1,1704297523,1704297524,1704297558,34,COMPLETED
5322558,1,1,1704297523,1704297524,1704297557,33,COMPLETED
5322559,1,1,1704297524,1704297524,1704297558,34,COMPLETED
5322560,1,1,1704297524,1704297524,1704297557,33,COMPLETED
5322561,1,1,1704297524,1704297524,1704297557,33,COMPLETED
5322562,1,1,1704297524,1704297524,1704297559,35,COMPLETED
5322563,1,1,1704297524,1704297524,1704297559,35,COMPLETED
5322564,1,1,1704297524,1704297524,1704297557,33,COMPLETED
5322565,1,1,1704297524,1704297524,1704297557,33,COMPLETED
5322566,1,1,1704297524,1704297524,1704297558,34,COMPLETED
5322567,1,1,1704297524,1704297524,1704297557,33,COMPLETED
5322568,1,1,1704297524,1704297524,1704297559,35,COMPLETED
5322569,1,1,1704297525,1704297528,1704297593,65,COMPLETED
5322570,1,1,1704297525,1704297528,1704297586,58,COMPLETED
5322571,1,1,1704297525,1704297528,1704297587,59,COMPLETED
5322572,1,1,1704297525,1704297528,1704297598,70,COMPLETED
5322573,1,1,1704297525,1704297528,1704297588,60,COMPLETED
5322574,1,1,1704297525,1704297528,1704297592,64,COMPLETED
5322575,1,1,1704297525,1704297528,1704297586,58,COMPLETED
5322576,1,1,1704297525,1704297528,1704297587,59,COMPLETED
5322577,1,1,1704297525,1704297528,1704297587,59,COMPLETED
5322578,1,1,1704297525,1704297528,1704297588,60,COMPLETED
5322579,1,1,1704297526,1704297528,1704297586,58,COMPLETED
5322580,1,1,1704297526,1704297528,1704297589,61,COMPLETED
5322581,1,1,1704297526,1704297528,1704297590,62,COMPLETED
5322582,1,1,1704297526,1704297528,1704297588,60,COMPLETED
5322583,1,1,1704297526,1704297528,1704297592,64,COMPLETED
5322584,1,1,1704297526,1704297528,1704297586,58,COMPLETED
5322585,1,1,1704297526,1704297528,1704297586,58,COMPLETED
5322586,1,1,1704297526,1704297528,1704297593,65,COMPLETED
5322587,1,1,1704297526,1704297528,1704297587,59,COMPLETED
5322588,1,1,1704297526,1704297528,1704297586,58,COMPLETED
5322589,1,1,1704297527,1704297528,1704297596,68,COMPLETED
5322590,1,1,1704297527,1704297528,1704297586,58,COMPLETED
5322591,1,1,1704297527,1704297528,1704297589,61,COMPLETED
5322592,1,1,1704297527,1704297528,1704297592,64,COMPLETED
5322593,1,1,1704297527,1704297528,1704297588,60,COMPLETED
5322594,1,1,1704297527,1704297528,1704297593,65,COMPLETED
5322595,1,1,1704297527,1704297528,1704297592,64,COMPLETED
5322596,1,1,1704297527,1704297528,1704297590,62,COMPLETED
5322597,1,1,1704297527,1704297528,1704297589,61,COMPLETED
5322598,1,1,1704297527,1704297528,1704297595,67,COMPLETED
5322599,1,1,1704297528,1704297528,1704297591,63,COMPLETED
5322600,1,1,1704297528,1704297528,1704297587,59,COMPLETED
5322601,1,1,1704297528,1704297528,1704297592,64,COMPLETED
5322602,1,1,1704297528,1704297532,1704297591,59,COMPLETED
5322603,1,1,1704297528,1704297532,1704297590,58,COMPLETED
5322604,1,1,1704297528,1704297532,1704297591,59,COMPLETED
5322605,1,1,1704297528,1704297532,1704297586,54,COMPLETED
5322606,1,1,1704297528,1704297532,1704297592,60,COMPLETED
5322607,1,1,1704297528,1704297532,1704297590,58,COMPLETED
5322608,1,1,1704297528,1704297532,1704297591,59,COMPLETED
5322609,1,1,1704297529,1704297532,1704297589,57,COMPLETED
5322610,1,1,1704297529,1704297532,1704297591,59,COMPLETED
5322611,1,1,1704297529,1704297532,1704297589,57,COMPLETED
5322612,1,1,1704297529,1704297532,1704297592,60,COMPLETED
5322613,1,1,1704297529,1704297532,1704297588,56,COMPLETED
5322614,1,1,1704297529,1704297532,1704297596,64,COMPLETED
5322615,1,1,1704297529,1704297532,1704297589,57,COMPLETED
5322616,1,1,1704297529,1704297532,1704297590,58,COMPLETED
5322617,1,1,1704297529,1704297532,1704297586,54,COMPLETED
5322618,1,1,1704297541,1704297541,1704297594,53,COMPLETED
5322619,1,1,1704297544,1704297545,1704297595,50,COMPLETED
5322620,1,1,1704297544,1704297545,1704297593,48,COMPLETED
5322621,1,1,1704297544,1704297545,1704297599,54,COMPLETED
5322622,1,1,1704297544,1704297545,1704297595,50,COMPLETED
5322623,1,1,1704297557,1704297557,1704297625,68,COMPLETED
5322624,1,1,1704297558,1704297559,1704297625,66,COMPLETED
5322625,1,1,1704297558,1704297559,1704297624,65,COMPLETED
5322626,1,1,1704297558,1704297559,1704297627,68,COMPLETED
5322627,1,1,1704297558,1704297559,1704297629,70,COMPLETED
5322628,1,1,1704297558,1704297559,1704297627,68,COMPLETED
5322629,1,1,1704297558,1704297559,1704297628,69,COMPLETED
5322630,1,1,1704297558,1704297559,1704297628,69,COMPLETED
5322631,1,1,1704297558,1704297559,1704297628,69,COMPLETED
5322632,1,1,1704297558,1704297559,1704297628,69,COMPLETED
5322633,1,1,1704297559,1704297559,1704297628,69,COMPLETED
5322634,1,1,1704297559,1704297559,1704297625,66,COMPLETED
5322635,1,1,1704297559,1704297559,1704297627,68,COMPLETED
5322636,1,1,1704297559,1704297559,1704297627,68,COMPLETED
5322637,1,1,1704297559,1704297560,1704297627,67,COMPLETED
5322638,1,1,1704297559,1704297560,1704297626,66,COMPLETED
5322639,1,1,1704297559,1704297560,1704297623,63,COMPLETED
5322640,1,1,1704297559,1704297560,1704297623,63,COMPLETED
5322641,1,1,1704297559,1704297560,1704297629,69,COMPLETED
5322642,1,1,1704297559,1704297560,1704297627,67,COMPLETED
5322643,1,1,1704297560,1704297560,1704297625,65,COMPLETED
5322644,1,1,1704297560,1704297560,1704297625,65,COMPLETED
5322645,1,1,1704297560,1704297560,1704297627,67,COMPLETED
5322646,1,1,1704297560,1704297560,1704297627,67,COMPLETED
5322647,1,1,1704297560,1704297560,1704297628,68,COMPLETED
5322648,1,1,1704297560,1704297560,1704297628,68,COMPLETED
5322649,1,1,1704297560,1704297560,1704297625,65,COMPLETED
5322650,1,1,1704297560,1704297560,1704297628,68,COMPLETED
5322651,1,1,1704297560,1704297560,1704297628,68,COMPLETED
5322652,1,1,1704297560,1704297560,1704297626,66,COMPLETED
5322653,1,1,1704297572,1704297572,1704297627,55,COMPLETED
5322654,1,1,1704297572,1704297573,1704297627,54,COMPLETED
5322655,1,1,1704297573,1704297573,1704297628,55,COMPLETED
5322656,1,1,1704297573,1704297573,1704297628,55,COMPLETED
5322657,1,1,1704297573,1704297573,1704297612,39,COMPLETED
5322658,1,1,1704297573,1704297573,1704297614,41,COMPLETED
5322659,1,1,1704297573,1704297573,1704297612,39,COMPLETED
5322660,1,1,1704297573,1704297573,1704297613,40,COMPLETED
5322661,1,1,1704297573,1704297573,1704297612,39,COMPLETED
5322662,1,1,1704297573,1704297573,1704297612,39,COMPLETED
5322663,1,1,1704297573,1704297573,1704297616,43,COMPLETED
5322664,1,1,1704297573,1704297573,1704297626,53,COMPLETED
5322665,1,1,1704297574,1704297576,1704297628,52,COMPLETED
5322666,1,1,1704297574,1704297576,1704297628,52,COMPLETED
5322667,1,1,1704297574,1704297576,1704297634,58,COMPLETED
5322668,1,1,1704297574,1704297576,1704297629,53,COMPLETED
5322669,1,1,1704297574,1704297576,1704297628,52,COMPLETED
5322670,1,1,1704297574,1704297576,1704297626,50,COMPLETED
5322671,1,1,1704297574,1704297576,1704297626,50,COMPLETED
5322672,1,1,1704297574,1704297576,1704297625,49,COMPLETED
5322673,1,1,1704297574,1704297576,1704297628,52,COMPLETED
5322674,1,1,1704297574,1704297576,1704297630,54,COMPLETED
5322675,1,1,1704297575,1704297576,1704297627,51,COMPLETED
5322676,1,1,1704297575,1704297576,1704297626,50,COMPLETED
5322677,1,1,1704297575,1704297576,1704297627,51,COMPLETED
5322678,1,1,1704297575,1704297576,1704297632,56,COMPLETED
5322679,1,1,1704297575,1704297576,1704297626,50,COMPLETED
5322680,1,1,1704297575,1704297576,1704297623,47,COMPLETED
5322681,1,1,1704297575,1704297576,1704297628,52,COMPLETED
5322682,1,1,1704297575,1704297576,1704297627,51,COMPLETED
5322683,1,1,1704297575,1704297576,1704297627,51,COMPLETED
5322684,1,1,1704297575,1704297576,1704297627,51,COMPLETED
5322685,1,1,1704297576,1704297576,1704297627,51,COMPLETED
5322686,1,1,1704297577,1704297580,1704297627,47,COMPLETED
5322687,1,1,1704297577,1704297580,1704297624,44,COMPLETED
5322688,1,1,1704297577,1704297580,1704297626,46,COMPLETED
5322689,1,1,1704297577,1704297580,1704297627,47,COMPLETED
5322690,1,1,1704297577,1704297580,1704297628,48,COMPLETED
5322691,1,1,1704297577,1704297580,1704297626,46,COMPLETED
5322692,1,1,1704297577,1704297580,1704297628,48,COMPLETED
5322693,1,1,1704297577,1704297580,1704297630,50,COMPLETED
5322694,1,1,1704297577,1704297580,1704297626,46,COMPLETED
5322695,1,1,1704297577,1704297580,1704297627,47,COMPLETED
5322696,1,1,1704297577,1704297580,1704297626,46,COMPLETED
5322697,1,1,1704297577,1704297580,1704297628,48,COMPLETED
5322698,1,1,1704297577,1704297580,1704297629,49,COMPLETED
5322699,1,1,1704297577,1704297580,1704297625,45,COMPLETED
5322700,1,1,1704297577,1704297580,1704297615,35,COMPLETED
5322701,1,1,1704297577,1704297580,1704297618,38,COMPLETED
5322702,1,1,1704297577,1704297580,1704297616,36,COMPLETED
5322703,1,1,1704297577,1704297580,1704297616,36,COMPLETED
5322704,1,1,1704297577,1704297580,1704297614,34,COMPLETED
5322705,1,1,1704297578,1704297580,1704297612,32,COMPLETED
5322706,1,1,1704297578,1704297580,1704297618,38,COMPLETED
5322707,1,1,1704297578,1704297580,1704297615,35,COMPLETED
5322708,1,1,1704297578,1704297580,1704297616,36,COMPLETED
5322709,1,1,1704297578,1704297580,1704297616,36,COMPLETED
5322710,1,1,1704297578,1704297580,1704297615,35,COMPLETED
5322711,1,1,1704297578,1704297580,1704297624,44,COMPLETED
5322712,1,1,1704297578,1704297580,1704297629,49,COMPLETED
5322713,1,1,1704297578,1704297580,1704297628,48,COMPLETED
5322714,1,1,1704297578,1704297580,1704297624,44,COMPLETED
5322715,1,1,1704297579,1704297580,1704297629,49,COMPLETED
5322716,1,1,1704297579,1704297580,1704297627,47,COMPLETED
5322717,1,1,1704297579,1704297580,1704297622,42,COMPLETED
5322718,1,1,1704297579,1704297580,1704297626,46,COMPLETED
5322719,1,1,1704297579,1704297580,1704297629,49,COMPLETED
5322720,1,1,1704297579,1704297580,1704297627,47,COMPLETED
5322721,1,1,1704297579,1704297580,1704297627,47,COMPLETED
5322722,1,1,1704297579,1704297580,1704297626,46,COMPLETED
5322723,1,1,1704297579,1704297580,1704297625,45,COMPLETED
5322724,1,1,1704297579,1704297580,1704297626,46,COMPLETED
5322725,1,1,1704297580,1704297580,1704297629,49,COMPLETED
5322726,1,1,1704297580,1704297580,1704297626,46,COMPLETED
5322727,1,1,1704297580,1704297582,1704297628,46,COMPLETED
5322728,1,1,1704297580,1704297582,1704297626,44,COMPLETED
5322729,1,1,1704297580,1704297582,1704297628,46,COMPLETED
5322730,1,1,1704297580,1704297582,1704297627,45,COMPLETED
5322731,1,1,1704297580,1704297582,1704297631,49,COMPLETED
5322732,1,1,1704297580,1704297582,1704297625,43,COMPLETED
5322733,1,1,1704297580,1704297582,1704297628,46,COMPLETED
5322734,1,1,1704297581,1704297582,1704297631,49,COMPLETED
5322735,1,1,1704297581,1704297582,1704297628,46,COMPLETED
5322736,1,1,1704297581,1704297582,1704297627,45,COMPLETED
5322737,1,1,1704297582,1704297582,1704297629,47,COMPLETED
5322738,1,1,1704297582,1704297582,1704297630,48,COMPLETED
5322739,1,1,1704297582,1704297582,1704297627,45,COMPLETED
5322740,1,1,1704297582,1704297582,1704297629,47,COMPLETED
5322741,1,1,1704297582,1704297582,1704297627,45,COMPLETED
5322742,1,1,1704297582,1704297582,1704297632,50,COMPLETED
5322743,1,1,1704297582,1704297582,1704297627,45,COMPLETED
5322744,1,1,1704297582,1704297584,1704297627,43,COMPLETED
5322745,1,1,1704297582,1704297584,1704297631,47,COMPLETED
5322746,1,1,1704297582,1704297584,1704297624,40,COMPLETED
5322747,1,1,1704297582,1704297584,1704297628,44,COMPLETED
5322748,1,1,1704297582,1704297584,1704297619,35,COMPLETED
5322749,1,1,1704297582,1704297584,1704297622,38,COMPLETED
5322750,1,1,1704297582,1704297584,1704297625,41,COMPLETED
5322751,1,1,1704297582,1704297584,1704297621,37,COMPLETED
5322752,1,1,1704297583,1704297584,1704297623,39,COMPLETED
5322753,1,1,1704297583,1704297584,1704297622,38,COMPLETED
5322754,1,1,1704297583,1704297584,1704297623,39,COMPLETED
5322755,1,1,1704297583,1704297584,1704297618,34,COMPLETED
5322756,1,1,1704297583,1704297584,1704297620,36,COMPLETED
5322757,1,1,1704297583,1704297584,1704297627,43,COMPLETED
5322758,1,1,1704297583,1704297584,1704297623,39,COMPLETED
5322759,1,1,1704297583,1704297584,1704297618,34,COMPLETED
5322760,1,1,1704297583,1704297584,1704297619,35,COMPLETED
5322761,1,1,1704297583,1704297584,1704297621,37,COMPLETED
5322762,1,1,1704297583,1704297584,1704297620,36,COMPLETED
5322763,1,1,1704297583,1704297584,1704297628,44,COMPLETED
5322764,1,1,1704297584,1704297584,1704297621,37,COMPLETED
5322765,1,1,1704297584,1704297584,1704297620,36,COMPLETED
5322766,1,1,1704297584,1704297584,1704297619,35,COMPLETED
5322767,1,1,1704297587,1704297587,1704297619,32,COMPLETED
5322768,1,1,1704297588,1704297588,1704297620,32,COMPLETED
5322769,1,1,1704297589,1704297589,1704297631,42,COMPLETED
5322770,1,1,1704297611,1704297611,1704297648,37,COMPLETED
5322771,1,1,1704297611,1704297611,1704297647,36,COMPLETED
5322772,1,1,1704297611,1704297611,1704297648,37,COMPLETED
5322773,1,1,1704297611,1704297611,1704297648,37,COMPLETED
5322774,1,1,1704297611,1704297611,1704297646,35,COMPLETED
5322775,1,1,1704297613,1704297613,1704297651,38,COMPLETED
5322776,1,1,1704297614,1704297614,1704297652,38,COMPLETED
5322777,1,1,1704297614,1704297614,1704297652,38,COMPLETED
5322778,1,1,1704297614,1704297615,1704297654,39,COMPLETED
5322779,1,1,1704297614,1704297615,1704297650,35,COMPLETED
5322780,1,1,1704297614,1704297615,1704297651,36,COMPLETED
5322781,1,1,1704297615,1704297615,1704297659,44,COMPLETED
5322782,1,1,1704297615,1704297615,1704297650,35,COMPLETED
5322783,1,1,1704297615,1704297615,1704297661,46,COMPLETED
5322784,1,1,1704297615,1704297615,1704297651,36,COMPLETED
5322785,1,1,1704297615,1704297615,1704297652,37,COMPLETED
5322786,1,1,1704297615,1704297615,1704297652,37,COMPLETED
5322787,1,1,1704297615,1704297615,1704297650,35,COMPLETED
5322788,1,1,1704297615,1704297615,1704297651,36,COMPLETED
5322789,1,1,1704297615,1704297615,1704297659,44,COMPLETED
5322790,1,1,1704297615,1704297615,1704297658,43,COMPLETED
5322791,1,1,1704297615,1704297616,1704297660,44,COMPLETED
5322792,1,1,1704297615,1704297616,1704297660,44,COMPLETED
5322793,1,1,1704297615,1704297616,1704297658,42,COMPLETED
5322794,1,1,1704297615,1704297616,1704297658,42,COMPLETED
5322795,1,1,1704297615,1704297616,1704297659,43,COMPLETED
5322796,1,1,1704297615,1704297616,1704297658,42,COMPLETED
5322797,1,1,1704297616,1704297616,1704297660,44,COMPLETED
5322798,1,1,1704297616,1704297616,1704297659,43,COMPLETED
5322799,1,1,1704297616,1704297616,1704297656,40,COMPLETED
5322800,1,1,1704297616,1704297616,1704297656,40,COMPLETED
5322801,1,1,1704297616,1704297616,1704297660,44,COMPLETED
5322802,1,1,1704297616,1704297616,1704297656,40,COMPLETED
5322803,1,1,1704297616,1704297616,1704297658,42,COMPLETED
5322804,1,1,1704297616,1704297616,1704297660,44,COMPLETED
5322805,1,1,1704297616,1704297616,1704297657,41,COMPLETED
5322806,1,1,1704297616,1704297616,1704297661,45,COMPLETED
5322807,1,1,1704297616,1704297616,1704297660,44,COMPLETED
5322808,1,1,1704297616,1704297616,1704297659,43,COMPLETED
5322809,1,1,1704297616,1704297616,1704297660,44,COMPLETED
5322810,1,1,1704297617,1704297618,1704297657,39,COMPLETED
5322811,1,1,1704297617,1704297618,1704297659,41,COMPLETED
5322812,1,1,1704297617,1704297618,1704297660,42,COMPLETED
5322813,1,1,1704297617,1704297618,1704297658,40,COMPLETED
5322814,1,1,1704297617,1704297618,1704297658,40,COMPLETED
5322815,1,1,1704297617,1704297618,1704297660,42,COMPLETED
5322816,1,1,1704297617,1704297618,1704297657,39,COMPLETED
5322817,1,1,1704297617,1704297618,1704297656,38,COMPLETED
5322818,1,1,1704297617,1704297618,1704297660,42,COMPLETED
5322819,1,1,1704297617,1704297618,1704297660,42,COMPLETED
5322820,1,1,1704297618,1704297618,1704297658,40,COMPLETED
5322821,1,1,1704297618,1704297619,1704297659,40,COMPLETED
5322822,1,1,1704297633,1704297634,1704297682,48,COMPLETED
5322823,1,1,1704297634,1704297636,1704297683,47,COMPLETED
5322824,1,1,1704297634,1704297636,1704297683,47,COMPLETED
5322825,1,1,1704297634,1704297636,1704297682,46,COMPLETED
5322826,1,1,1704297634,1704297636,1704297682,46,COMPLETED
5322827,1,1,1704297634,1704297636,1704297683,47,COMPLETED
5322828,1,1,1704297634,1704297636,1704297683,47,COMPLETED
5322829,1,1,1704297634,1704297636,1704297682,46,COMPLETED
5322830,1,1,1704297634,1704297636,1704297682,46,COMPLETED
5322831,1,1,1704297634,1704297636,1704297683,47,COMPLETED
5322832,1,1,1704297634,1704297636,1704297682,46,COMPLETED
5322833,1,1,1704297634,1704297636,1704297682,46,COMPLETED
5322834,1,1,1704297635,1704297636,1704297682,46,COMPLETED
5322835,1,1,1704297635,1704297636,1704297685,49,COMPLETED
5322836,1,1,1704297635,1704297636,1704297682,46,COMPLETED
5322837,1,1,1704297635,1704297636,1704297683,47,COMPLETED
5322838,1,1,1704297635,1704297636,1704297684,48,COMPLETED
5322839,1,1,1704297635,1704297636,1704297682,46,COMPLETED
5322840,1,1,1704297635,1704297636,1704297683,47,COMPLETED
5322841,1,1,1704297635,1704297636,1704297684,48,COMPLETED
5322842,1,1,1704297635,1704297636,1704297685,49,COMPLETED
5322843,1,1,1704297635,1704297636,1704297682,46,COMPLETED
5322844,1,1,1704297635,1704297636,1704297686,50,COMPLETED
5322845,1,1,1704297635,1704297636,1704297682,46,COMPLETED
5322846,1,1,1704297635,1704297636,1704297684,48,COMPLETED
5322847,1,1,1704297635,1704297636,1704297683,47,COMPLETED
5322848,1,1,1704297636,1704297636,1704297683,47,COMPLETED
5322849,1,1,1704297636,1704297638,1704297683,45,COMPLETED
5322850,1,1,1704297636,1704297638,1704297684,46,COMPLETED
5322851,1,1,1704297636,1704297638,1704297684,46,COMPLETED
5322852,1,1,1704297637,1704297638,1704297684,46,COMPLETED
5322853,1,1,1704297637,1704297638,1704297683,45,COMPLETED
5322854,1,1,1704297637,1704297638,1704297682,44,COMPLETED
5322855,1,1,1704297637,1704297638,1704297682,44,COMPLETED
5322856,1,1,1704297637,1704297638,1704297682,44,COMPLETED
5322857,1,1,1704297637,1704297638,1704297684,46,COMPLETED
5322858,1,1,1704297637,1704297638,1704297682,44,COMPLETED
5322859,1,1,1704297637,1704297638,1704297683,45,COMPLETED
5322860,1,1,1704297637,1704297638,1704297681,43,COMPLETED
5322861,1,1,1704297637,1704297638,1704297683,45,COMPLETED
5322862,1,1,1704297637,1704297638,1704297682,44,COMPLETED
5322863,1,1,1704297637,1704297638,1704297681,43,COMPLETED
5322864,1,1,1704297638,1704297638,1704297683,45,COMPLETED
5322865,1,1,1704297638,1704297638,1704297682,44,COMPLETED
5322866,1,1,1704297638,1704297638,1704297682,44,COMPLETED
5322867,1,1,1704297638,1704297638,1704297682,44,COMPLETED
5322868,1,1,1704297638,1704297638,1704297683,45,COMPLETED
5322869,1,1,1704297638,1704297642,1704297682,40,COMPLETED
5322870,1,1,1704297638,1704297642,1704297682,40,COMPLETED
5322871,1,1,1704297638,1704297642,1704297682,40,COMPLETED
5322872,1,1,1704297638,1704297642,1704297681,39,COMPLETED
5322873,1,1,1704297638,1704297642,1704297682,40,COMPLETED
5322874,1,1,1704297638,1704297642,1704297688,46,COMPLETED
5322875,1,1,1704297638,1704297642,1704297682,40,COMPLETED
5322876,1,1,1704297638,1704297642,1704297682,40,COMPLETED
5322877,1,1,1704297639,1704297642,1704297682,40,COMPLETED
5322878,1,1,1704297639,1704297642,1704297685,43,COMPLETED
5322879,1,1,1704297639,1704297642,1704297682,40,COMPLETED
5322880,1,1,1704297639,1704297642,1704297682,40,COMPLETED
5322881,1,1,1704297640,1704297642,1704297688,46,COMPLETED
5322882,1,1,1704297640,1704297642,1704297682,40,COMPLETED
5322883,1,1,1704297640,1704297642,1704297684,42,COMPLETED
5322884,1,1,1704297640,1704297642,1704297682,40,COMPLETED
5322885,1,1,1704297640,1704297642,1704297682,40,COMPLETED
5322886,36,1,1704297694,1704297695,1704298017,322,COMPLETED
5322887,36,1,1704297709,1704298019,1704299051,1032,COMPLETED
5322888,1,1,1704297734,1704297734,1704297782,48,COMPLETED
5322889,1,1,1704297734,1704297734,1704297783,49,COMPLETED
5322890,1,1,1704297734,1704297734,1704297782,48,COMPLETED
5322891,1,1,1704297734,1704297734,1704297782,48,COMPLETED
5322892,1,1,1704297734,1704297734,1704297782,48,COMPLETED
5322893,1,1,1704297734,1704297734,1704297782,48,COMPLETED
5322894,1,1,1704297734,1704297734,1704297782,48,COMPLETED
5322895,1,1,1704297734,1704297734,1704297782,48,COMPLETED
5322896,1,1,1704297734,1704297734,1704297782,48,COMPLETED
5322897,1,1,1704297734,1704297734,1704297787,53,COMPLETED
5322898,1,1,1704297734,1704297734,1704297782,48,COMPLETED
5322899,1,1,1704297734,1704297734,1704297788,54,COMPLETED
5322900,1,1,1704297734,1704297734,1704297782,48,COMPLETED
5322901,1,1,1704297734,1704297734,1704297782,48,COMPLETED
5322902,1,1,1704297734,1704297734,1704297782,48,COMPLETED
5322903,1,1,1704297734,1704297734,1704297782,48,COMPLETED
5322904,1,1,1704297734,1704297734,1704297785,51,COMPLETED
5322905,1,1,1704297734,1704297738,1704297782,44,COMPLETED
5322906,1,1,1704297734,1704297738,1704297782,44,COMPLETED
5322907,1,1,1704297734,1704297738,1704297782,44,COMPLETED
5322908,1,1,1704297735,1704297738,1704297782,44,COMPLETED
5322909,1,1,1704297735,1704297738,1704297788,50,COMPLETED
5322910,1,1,1704297735,1704297738,1704297783,45,COMPLETED
5322911,1,1,1704297735,1704297738,1704297782,44,COMPLETED
5322912,1,1,1704297735,1704297738,1704297782,44,COMPLETED
5322913,1,1,1704297735,1704297738,1704297782,44,COMPLETED
5322914,1,1,1704297735,1704297738,1704297782,44,COMPLETED
5322915,1,1,1704297735,1704297738,1704297782,44,COMPLETED
5322916,1,1,1704297735,1704297738,1704297782,44,COMPLETED
5322917,1,1,1704297735,1704297738,1704297782,44,COMPLETED
5322918,1,1,1704297735,1704297738,1704297782,44,COMPLETED
5322919,1,1,1704297735,1704297738,1704297782,44,COMPLETED
5322920,1,1,1704297735,1704297738,1704297782,44,COMPLETED
5322921,1,1,1704297735,1704297738,1704297782,44,COMPLETED
5322922,1,1,1704297735,1704297738,1704297782,44,COMPLETED
5322923,1,1,1704297735,1704297738,1704297782,44,COMPLETED
5322924,1,1,1704297735,1704297738,1704297782,44,COMPLETED
5322925,1,1,1704297735,1704297738,1704297783,45,COMPLETED
5322926,1,1,1704297735,1704297738,1704297783,45,COMPLETED
5322927,1,1,1704297735,1704297738,1704297782,44,COMPLETED
5322928,1,1,1704297735,1704297738,1704297785,47,COMPLETED
5322929,1,1,1704297735,1704297738,1704297783,45,COMPLETED
5322930,1,1,1704297735,1704297738,1704297783,45,COMPLETED
5322931,1,1,1704297735,1704297738,1704297783,45,COMPLETED
5322932,1,1,1704297735,1704297738,1704297784,46,COMPLETED
5322933,1,1,1704297735,1704297738,1704297782,44,COMPLETED
5322934,1,1,1704297735,1704297738,1704297782,44,COMPLETED
5322935,1,1,1704297735,1704297738,1704297783,45,COMPLETED
5322936,1,1,1704297735,1704297738,1704297783,45,COMPLETED
5322937,1,1,1704297735,1704297738,1704297782,44,COMPLETED
5322938,1,1,1704297735,1704297738,1704297783,45,COMPLETED
5322939,1,1,1704297735,1704297738,1704297782,44,COMPLETED
5322940,1,1,1704297735,1704297738,1704297782,44,COMPLETED
5322941,1,1,1704297735,1704297738,1704297784,46,COMPLETED
5322942,1,1,1704297735,1704297738,1704297783,45,COMPLETED
5322943,1,1,1704297735,1704297738,1704297783,45,COMPLETED
5322944,1,1,1704297735,1704297738,1704297782,44,COMPLETED
5322945,1,1,1704297735,1704297738,1704297782,44,COMPLETED
5322946,1,1,1704297735,1704297738,1704297783,45,COMPLETED
5322947,1,1,1704297735,1704297738,1704297782,44,COMPLETED
5322948,1,1,1704297735,1704297738,1704297783,45,COMPLETED
5322949,1,1,1704297735,1704297738,1704297782,44,COMPLETED
5322950,1,1,1704297735,1704297738,1704297785,47,COMPLETED
5322951,1,1,1704297735,1704297738,1704297783,45,COMPLETED
5322952,1,1,1704297736,1704297738,1704297782,44,COMPLETED
5322953,1,1,1704297736,1704297738,1704297783,45,COMPLETED
5322954,1,1,1704297736,1704297738,1704297782,44,COMPLETED
5322955,1,1,1704297736,1704297738,1704297783,45,COMPLETED
5322956,1,1,1704297736,1704297738,1704297782,44,COMPLETED
5322957,1,1,1704297736,1704297738,1704297783,45,COMPLETED
5322958,1,1,1704297736,1704297738,1704297783,45,COMPLETED
5322959,1,1,1704297736,1704297738,1704297783,45,COMPLETED
5322960,1,1,1704297736,1704297738,1704297783,45,COMPLETED
5322961,1,1,1704297736,1704297738,1704297785,47,COMPLETED
5322962,1,1,1704297736,1704297738,1704297782,44,COMPLETED
5322963,1,1,1704297736,1704297738,1704297782,44,COMPLETED
5322964,1,1,1704297736,1704297738,1704297782,44,COMPLETED
5322965,1,1,1704297736,1704297738,1704297783,45,COMPLETED
5322966,1,1,1704297736,1704297738,1704297782,44,COMPLETED
5322967,1,1,1704297736,1704297738,1704297782,44,COMPLETED
5322968,1,1,1704297736,1704297738,1704297783,45,COMPLETED
5322969,1,1,1704297736,1704297738,1704297782,44,COMPLETED
5322970,1,1,1704297736,1704297738,1704297783,45,COMPLETED
5322971,1,1,1704297736,1704297738,1704297782,44,COMPLETED
5322972,1,1,1704297736,1704297738,1704297782,44,COMPLETED
5322973,1,1,1704297736,1704297738,1704297782,44,COMPLETED
5322974,1,1,1704297736,1704297738,1704297784,46,COMPLETED
5322975,1,1,1704297736,1704297738,1704297782,44,COMPLETED
5322976,1,1,1704297736,1704297738,1704297783,45,COMPLETED
5322977,1,1,1704297736,1704297738,1704297782,44,COMPLETED
5322978,1,1,1704297736,1704297738,1704297782,44,COMPLETED
5322979,1,1,1704297736,1704297738,1704297782,44,COMPLETED
5322980,1,1,1704297736,1704297738,1704297782,44,COMPLETED
5322981,1,1,1704297736,1704297738,1704297782,44,COMPLETED
5322982,1,1,1704297736,1704297738,1704297782,44,COMPLETED
5322983,1,1,1704297736,1704297738,1704297782,44,COMPLETED
5322984,1,1,1704297736,1704297738,1704297782,44,COMPLETED
5322985,1,1,1704297736,1704297738,1704297782,44,COMPLETED
5322986,1,1,1704297736,1704297738,1704297782,44,COMPLETED
5322987,1,1,1704297736,1704297738,1704297782,44,COMPLETED
5322988,1,1,1704297736,1704297738,1704297783,45,COMPLETED
5322989,1,1,1704297736,1704297738,1704297782,44,COMPLETED
5322990,1,1,1704297736,1704297738,1704297782,44,COMPLETED
5322991,1,1,1704297736,1704297738,1704297783,45,COMPLETED
5322992,1,1,1704297736,1704297738,1704297783,45,COMPLETED
5322993,1,1,1704297736,1704297738,1704297782,44,COMPLETED
5322994,1,1,1704297736,1704297738,1704297783,45,COMPLETED
5322995,1,1,1704297736,1704297738,1704297789,51,COMPLETED
5322996,1,1,1704297736,1704297738,1704297782,44,COMPLETED
5322997,1,1,1704297736,1704297738,1704297782,44,COMPLETED
5322998,1,1,1704297736,1704297738,1704297790,52,COMPLETED
5322999,1,1,1704297736,1704297738,1704297784,46,COMPLETED
5323000,1,1,1704297736,1704297738,1704297782,44,COMPLETED
5323001,1,1,1704297736,1704297738,1704297783,45,COMPLETED
5323002,1,1,1704297736,1704297738,1704297784,46,COMPLETED
5323003,1,1,1704297736,1704297738,1704297782,44,COMPLETED
5323004,1,1,1704297736,1704297738,1704297784,46,COMPLETED
5323005,1,1,1704297736,1704297738,1704297782,44,COMPLETED
5323006,1,1,1704297736,1704297738,1704297782,44,COMPLETED
5323007,1,1,1704297736,1704297738,1704297782,44,COMPLETED
5323008,1,1,1704297736,1704297738,1704297782,44,COMPLETED
5323009,1,1,1704297736,1704297738,1704297782,44,COMPLETED
5323010,1,1,1704297736,1704297738,1704297783,45,COMPLETED
5323011,1,1,1704297736,1704297738,1704297784,46,COMPLETED
5323012,1,1,1704297736,1704297738,1704297783,45,COMPLETED
5323013,1,1,1704297736,1704297738,1704297785,47,COMPLETED
5323014,1,1,1704297736,1704297738,1704297788,50,COMPLETED
5323015,1,1,1704297736,1704297738,1704297783,45,COMPLETED
5323016,1,1,1704297736,1704297738,1704297788,50,COMPLETED
5323017,1,1,1704297736,1704297738,1704297782,44,COMPLETED
5323018,1,1,1704297736,1704297738,1704297782,44,COMPLETED
5323019,1,1,1704297736,1704297738,1704297782,44,COMPLETED
5323020,1,1,1704297736,1704297738,1704297782,44,COMPLETED
5323021,1,1,1704297736,1704297738,1704297782,44,COMPLETED
5323022,1,1,1704297736,1704297738,1704297782,44,COMPLETED
5323023,1,1,1704297737,1704297738,1704297783,45,COMPLETED
5323024,1,1,1704297737,1704297738,1704297782,44,COMPLETED
5323025,1,1,1704297737,1704297738,1704297782,44,COMPLETED
5323026,1,1,1704297737,1704297738,1704297782,44,COMPLETED
5323027,1,1,1704297737,1704297738,1704297782,44,COMPLETED
5323028,1,1,1704297737,1704297738,1704297784,46,COMPLETED
5323029,1,1,1704297737,1704297738,1704297782,44,COMPLETED
5323030,1,1,1704297737,1704297738,1704297782,44,COMPLETED
5323031,1,1,1704297737,1704297738,1704297783,45,COMPLETED
5323032,1,1,1704297737,1704297738,1704297783,45,COMPLETED
5323033,1,1,1704297737,1704297738,1704297783,45,COMPLETED
5323034,1,1,1704297737,1704297738,1704297782,44,COMPLETED
5323035,1,1,1704297737,1704297738,1704297782,44,COMPLETED
5323036,1,1,1704297737,1704297738,1704297785,47,COMPLETED
5323037,1,1,1704297737,1704297738,1704297782,44,COMPLETED
5323038,1,1,1704297737,1704297738,1704297783,45,COMPLETED
5323039,1,1,1704297737,1704297738,1704297782,44,COMPLETED
5323040,1,1,1704297737,1704297738,1704297784,46,COMPLETED
5323041,1,1,1704297737,1704297738,1704297783,45,COMPLETED
5323042,1,1,1704297737,1704297738,1704297786,48,COMPLETED
5323043,1,1,1704297737,1704297738,1704297784,46,COMPLETED
5323044,1,1,1704297737,1704297738,1704297785,47,COMPLETED
5323045,1,1,1704297737,1704297738,1704297782,44,COMPLETED
5323046,1,1,1704297737,1704297738,1704297784,46,COMPLETED
5323047,1,1,1704297737,1704297738,1704297782,44,COMPLETED
5323048,1,1,1704297737,1704297738,1704297787,49,COMPLETED
5323049,1,1,1704297737,1704297738,1704297782,44,COMPLETED
5323050,1,1,1704297737,1704297738,1704297782,44,COMPLETED
5323051,1,1,1704297737,1704297738,1704297782,44,COMPLETED
5323052,1,1,1704297737,1704297738,1704297782,44,COMPLETED
5323053,1,1,1704297737,1704297738,1704297783,45,COMPLETED
5323054,1,1,1704297737,1704297738,1704297784,46,COMPLETED
5323055,1,1,1704297737,1704297738,1704297783,45,COMPLETED
5323056,1,1,1704297737,1704297738,1704297783,45,COMPLETED
5323057,1,1,1704297737,1704297738,1704297784,46,COMPLETED
5323058,1,1,1704297737,1704297738,1704297785,47,COMPLETED
5323059,1,1,1704297737,1704297738,1704297783,45,COMPLETED
5323060,1,1,1704297737,1704297738,1704297783,45,COMPLETED
5323061,1,1,1704297737,1704297738,1704297784,46,COMPLETED
5323062,1,1,1704297737,1704297738,1704297782,44,COMPLETED
5323063,1,1,1704297737,1704297738,1704297782,44,COMPLETED
5323064,1,1,1704297737,1704297738,1704297783,45,COMPLETED
5323065,1,1,1704297737,1704297738,1704297782,44,COMPLETED
5323066,1,1,1704297737,1704297738,1704297783,45,COMPLETED
5323067,1,1,1704297737,1704297738,1704297782,44,COMPLETED
5323068,1,1,1704297737,1704297738,1704297782,44,COMPLETED
5323069,1,1,1704297737,1704297738,1704297782,44,COMPLETED
5323070,1,1,1704297737,1704297738,1704297782,44,COMPLETED
5323071,1,1,1704297737,1704297738,1704297782,44,COMPLETED
5323072,1,1,1704297737,1704297738,1704297782,44,COMPLETED
5323073,1,1,1704297737,1704297738,1704297782,44,COMPLETED
5323074,1,1,1704297737,1704297738,1704297782,44,COMPLETED
5323075,1,1,1704297737,1704297738,1704297782,44,COMPLETED
5323076,1,1,1704297737,1704297738,1704297782,44,COMPLETED
5323077,1,1,1704297737,1704297738,1704297782,44,COMPLETED
5323078,1,1,1704297737,1704297738,1704297782,44,COMPLETED
5323079,1,1,1704297737,1704297738,1704297782,44,COMPLETED
5323080,1,1,1704297737,1704297738,1704297782,44,COMPLETED
5323081,1,1,1704297737,1704297738,1704297783,45,COMPLETED
5323082,1,1,1704297737,1704297738,1704297782,44,COMPLETED
5323083,1,1,1704297737,1704297738,1704297782,44,COMPLETED
5323084,1,1,1704297737,1704297738,1704297782,44,COMPLETED
5323085,1,1,1704297737,1704297738,1704297782,44,COMPLETED
5323086,1,1,1704297738,1704297738,1704297788,50,COMPLETED
5323087,1,1,1704297738,1704297738,1704297782,44,COMPLETED
5323088,1,1,1704297783,1704297784,1704297814,30,COMPLETED
5323089,1,1,1704297784,1704297784,1704297814,30,COMPLETED
5323090,1,1,1704297784,1704297784,1704297816,32,COMPLETED
5323091,1,1,1704297784,1704297784,1704297815,31,COMPLETED
5323092,1,1,1704297784,1704297784,1704297816,32,COMPLETED
5323093,1,1,1704297784,1704297784,1704297816,32,COMPLETED
5323094,1,1,1704297784,1704297784,1704297816,32,COMPLETED
5323095,1,1,1704297784,1704297784,1704297816,32,COMPLETED
5323096,1,1,1704297784,1704297784,1704297815,31,COMPLETED
5323097,1,1,1704297785,1704297785,1704297815,30,COMPLETED
5323098,1,1,1704297785,1704297785,1704297816,31,COMPLETED
5323099,1,1,1704297785,1704297785,1704297816,31,COMPLETED
5323100,1,1,1704297785,1704297785,1704297815,30,COMPLETED
5323101,1,1,1704297785,1704297785,1704297814,29,COMPLETED
5323102,1,1,1704297785,1704297785,1704297815,30,COMPLETED
5323103,1,1,1704297785,1704297785,1704297815,30,COMPLETED
5323104,1,1,1704297785,1704297785,1704297814,29,COMPLETED
5323105,1,1,1704297785,1704297785,1704297816,31,COMPLETED
5323106,1,1,1704297785,1704297785,1704297815,30,COMPLETED
5323107,1,1,1704297785,1704297785,1704297815,30,COMPLETED
5323108,1,1,1704297786,1704297786,1704297816,30,COMPLETED
5323109,1,1,1704297786,1704297786,1704297815,29,COMPLETED
5323110,1,1,1704297786,1704297786,1704297813,27,COMPLETED
5323111,1,1,1704297786,1704297786,1704297813,27,COMPLETED
5323112,1,1,1704297786,1704297786,1704297813,27,COMPLETED
5323113,1,1,1704297786,1704297786,1704297813,27,COMPLETED
5323114,1,1,1704297786,1704297786,1704297813,27,COMPLETED
5323115,1,1,1704297786,1704297786,1704297818,32,COMPLETED
5323116,1,1,1704297786,1704297786,1704297816,30,COMPLETED
5323117,1,1,1704297786,1704297786,1704297816,30,COMPLETED
5323118,1,1,1704297787,1704297787,1704297817,30,COMPLETED
5323119,1,1,1704297787,1704297787,1704297816,29,COMPLETED
5323120,1,1,1704297787,1704297787,1704297817,30,COMPLETED
5323121,1,1,1704297787,1704297787,1704297817,30,COMPLETED
5323122,1,1,1704297787,1704297787,1704297817,30,COMPLETED
5323123,1,1,1704297787,1704297787,1704297817,30,COMPLETED
5323124,1,1,1704297787,1704297788,1704297817,29,COMPLETED
5323125,1,1,1704297787,1704297788,1704297817,29,COMPLETED
5323126,1,1,1704297787,1704297788,1704297818,30,COMPLETED
5323127,1,1,1704297787,1704297788,1704297816,28,COMPLETED
5323128,1,1,1704297787,1704297788,1704297815,27,COMPLETED
5323129,1,1,1704297787,1704297788,1704297817,29,COMPLETED
5323130,1,1,1704297788,1704297788,1704297816,28,COMPLETED
5323131,1,1,1704297788,1704297788,1704297818,30,COMPLETED
5323132,1,1,1704297788,1704297788,1704297816,28,COMPLETED
5323133,1,1,1704297788,1704297788,1704297816,28,COMPLETED
5323134,1,1,1704297788,1704297789,1704297816,27,COMPLETED
5323135,1,1,1704297788,1704297789,1704297817,28,COMPLETED
5323136,1,1,1704297788,1704297789,1704297817,28,COMPLETED
5323137,1,1,1704297788,1704297789,1704297817,28,COMPLETED
5323138,1,1,1704297788,1704297789,1704297817,28,COMPLETED
5323139,1,1,1704297789,1704297789,1704297816,27,COMPLETED
5323140,1,1,1704297789,1704297789,1704297813,24,COMPLETED
5323141,1,1,1704297789,1704297789,1704297813,24,COMPLETED
5323142,1,1,1704297789,1704297789,1704297813,24,COMPLETED
5323143,1,1,1704297789,1704297789,1704297813,24,COMPLETED
5323144,1,1,1704297789,1704297789,1704297813,24,COMPLETED
5323145,1,1,1704297789,1704297789,1704297813,24,COMPLETED
5323146,1,1,1704297789,1704297789,1704297813,24,COMPLETED
5323147,1,1,1704297789,1704297790,1704297813,23,COMPLETED
5323148,1,1,1704297790,1704297790,1704297813,23,COMPLETED
5323149,1,1,1704297790,1704297790,1704297813,23,COMPLETED
5323150,1,1,1704297790,1704297790,1704297813,23,COMPLETED
5323151,1,1,1704297790,1704297790,1704297813,23,COMPLETED
5323152,1,1,1704297790,1704297790,1704297813,23,COMPLETED
5323153,1,1,1704297790,1704297790,1704297813,23,COMPLETED
5323154,1,1,1704297805,1704297807,1704297852,45,COMPLETED
5323155,1,1,1704297806,1704297807,1704297852,45,COMPLETED
5323156,1,1,1704297806,1704297807,1704297852,45,COMPLETED
5323157,1,1,1704297806,1704297807,1704297854,47,COMPLETED
5323158,1,1,1704297806,1704297807,1704297851,44,COMPLETED
5323159,1,1,1704297806,1704297807,1704297852,45,COMPLETED
5323160,1,1,1704297806,1704297807,1704297853,46,COMPLETED
5323161,1,1,1704297806,1704297807,1704297851,44,COMPLETED
5323162,1,1,1704297806,1704297807,1704297850,43,COMPLETED
5323163,1,1,1704297806,1704297807,1704297852,45,COMPLETED
5323164,1,1,1704297806,1704297807,1704297853,46,COMPLETED
5323165,1,1,1704297807,1704297807,1704297850,43,COMPLETED
5323166,1,1,1704297807,1704297807,1704297850,43,COMPLETED
5323167,1,1,1704297807,1704297807,1704297854,47,COMPLETED
5323168,1,1,1704297807,1704297807,1704297853,46,COMPLETED
5323169,1,1,1704297807,1704297807,1704297852,45,COMPLETED
5323170,1,1,1704297807,1704297807,1704297853,46,COMPLETED
5323171,1,1,1704297807,1704297807,1704297850,43,COMPLETED
5323172,1,1,1704297807,1704297807,1704297851,44,COMPLETED
5323173,1,1,1704297807,1704297807,1704297852,45,COMPLETED
5323174,1,1,1704297807,1704297807,1704297854,47,COMPLETED
5323175,1,1,1704297808,1704297811,1704297852,41,COMPLETED
5323176,1,1,1704297808,1704297811,1704297853,42,COMPLETED
5323177,1,1,1704297808,1704297811,1704297851,40,COMPLETED
5323178,1,1,1704297808,1704297811,1704297851,40,COMPLETED
5323179,1,1,1704297808,1704297811,1704297856,45,COMPLETED
5323180,1,1,1704297808,1704297811,1704297852,41,COMPLETED
5323181,1,1,1704297808,1704297811,1704297850,39,COMPLETED
5323182,1,1,1704297808,1704297811,1704297855,44,COMPLETED
5323183,1,1,1704297808,1704297811,1704297854,43,COMPLETED
5323184,1,1,1704297808,1704297811,1704297853,42,COMPLETED
5323185,1,1,1704297809,1704297811,1704297854,43,COMPLETED
5323186,1,1,1704297809,1704297811,1704297850,39,COMPLETED
5323187,1,1,1704297809,1704297811,1704297854,43,COMPLETED
5323188,1,1,1704297809,1704297811,1704297854,43,COMPLETED
5323189,1,1,1704297809,1704297811,1704297851,40,COMPLETED
5323190,1,1,1704297809,1704297811,1704297853,42,COMPLETED
5323191,1,1,1704297809,1704297811,1704297852,41,COMPLETED
5323192,1,1,1704297809,1704297811,1704297851,40,COMPLETED
5323193,1,1,1704297809,1704297811,1704297854,43,COMPLETED
5323194,1,1,1704297809,1704297811,1704297854,43,COMPLETED
5323195,1,1,1704297810,1704297811,1704297853,42,COMPLETED
5323196,1,1,1704297810,1704297811,1704297854,43,COMPLETED
5323197,1,1,1704297810,1704297811,1704297854,43,COMPLETED
5323198,1,1,1704297810,1704297811,1704297854,43,COMPLETED
5323199,1,1,1704297810,1704297811,1704297851,40,COMPLETED
5323200,1,1,1704297810,1704297811,1704297852,41,COMPLETED
5323201,1,1,1704297810,1704297811,1704297850,39,COMPLETED
5323202,1,1,1704297810,1704297811,1704297851,40,COMPLETED
5323203,1,1,1704297810,1704297811,1704297854,43,COMPLETED
5323204,1,1,1704297810,1704297811,1704297852,41,COMPLETED
5323205,1,1,1704297811,1704297811,1704297852,41,COMPLETED
5323206,1,1,1704297811,1704297811,1704297853,42,COMPLETED
5323207,1,1,1704297811,1704297811,1704297854,43,COMPLETED
5323208,1,1,1704297811,1704297811,1704297855,44,COMPLETED
5323209,1,1,1704297811,1704297811,1704297851,40,COMPLETED
5323210,1,1,1704297811,1704297811,1704297854,43,COMPLETED
5323211,1,1,1704297811,1704297811,1704297850,39,COMPLETED
5323212,1,1,1704297811,1704297811,1704297850,39,COMPLETED
5323213,1,1,1704297811,1704297814,1704297848,34,COMPLETED
5323214,1,1,1704297811,1704297814,1704297848,34,COMPLETED
5323215,1,1,1704297812,1704297814,1704297848,34,COMPLETED
5323216,1,1,1704297812,1704297814,1704297848,34,COMPLETED
5323217,1,1,1704297812,1704297814,1704297848,34,COMPLETED
5323218,1,1,1704297812,1704297814,1704297848,34,COMPLETED
5323219,1,1,1704297812,1704297814,1704297848,34,COMPLETED
5323220,1,1,1704297812,1704297814,1704297848,34,COMPLETED
5323221,1,1,1704297812,1704297814,1704297848,34,COMPLETED
5323222,1,1,1704297812,1704297814,1704297848,34,COMPLETED
5323223,1,1,1704297812,1704297814,1704297850,36,COMPLETED
5323224,1,1,1704297812,1704297814,1704297854,40,COMPLETED
5323225,1,1,1704297813,1704297814,1704297853,39,COMPLETED
5323226,1,1,1704297813,1704297814,1704297854,40,COMPLETED
5323227,1,1,1704297813,1704297814,1704297854,40,COMPLETED
5323228,1,1,1704297813,1704297814,1704297852,38,COMPLETED
5323229,1,1,1704297813,1704297814,1704297852,38,COMPLETED
5323230,1,1,1704297813,1704297814,1704297853,39,COMPLETED
5323231,1,1,1704297813,1704297814,1704297851,37,COMPLETED
5323232,1,1,1704297813,1704297814,1704297853,39,COMPLETED
5323233,1,1,1704297813,1704297814,1704297852,38,COMPLETED
5323234,1,1,1704297813,1704297814,1704297854,40,COMPLETED
5323235,1,1,1704297814,1704297814,1704297853,39,COMPLETED
5323236,1,1,1704297814,1704297814,1704297856,42,COMPLETED
5323237,1,1,1704297814,1704297814,1704297852,38,COMPLETED
5323238,1,1,1704297814,1704297814,1704297851,37,COMPLETED
5323239,1,1,1704297814,1704297814,1704297850,36,COMPLETED
5323240,1,1,1704297814,1704297814,1704297851,37,COMPLETED
5323241,1,1,1704297814,1704297814,1704297851,37,COMPLETED
5323242,1,1,1704297814,1704297814,1704297852,38,COMPLETED
5323243,1,1,1704297814,1704297814,1704297854,40,COMPLETED
5323244,1,1,1704297814,1704297814,1704297854,40,COMPLETED
5323245,1,1,1704297815,1704297815,1704297853,38,COMPLETED
5323246,1,1,1704297815,1704297815,1704297852,37,COMPLETED
5323247,1,1,1704297815,1704297815,1704297851,36,COMPLETED
5323248,1,1,1704297815,1704297815,1704297853,38,COMPLETED
5323249,1,1,1704297815,1704297815,1704297853,38,COMPLETED
5323250,1,1,1704297815,1704297815,1704297856,41,COMPLETED
5323251,1,1,1704297815,1704297816,1704297851,35,COMPLETED
5323252,1,1,1704297815,1704297816,1704297853,37,COMPLETED
5323253,1,1,1704297815,1704297816,1704297853,37,COMPLETED
5323254,1,1,1704297815,1704297816,1704297853,37,COMPLETED
5323255,1,1,1704297816,1704297816,1704297853,37,COMPLETED
5323256,1,1,1704297816,1704297816,1704297852,36,COMPLETED
5323257,1,1,1704297816,1704297816,1704297852,36,COMPLETED
5323258,1,1,1704297816,1704297816,1704297850,34,COMPLETED
5323259,1,1,1704297816,1704297816,1704297853,37,COMPLETED
5323260,1,1,1704297816,1704297816,1704297852,36,COMPLETED
5323261,1,1,1704297816,1704297816,1704297856,40,COMPLETED
5323262,1,1,1704297816,1704297816,1704297850,34,COMPLETED
5323263,1,1,1704297816,1704297816,1704297856,40,COMPLETED
5323264,1,1,1704297816,1704297816,1704297853,37,COMPLETED
5323265,1,1,1704297817,1704297817,1704297850,33,COMPLETED
5323266,1,1,1704297817,1704297817,1704297855,38,COMPLETED
5323267,1,1,1704297817,1704297817,1704297853,36,COMPLETED
5323268,1,1,1704297817,1704297817,1704297859,42,COMPLETED
5323269,1,1,1704297817,1704297817,1704297850,33,COMPLETED
5323270,1,1,1704297817,1704297817,1704297855,38,COMPLETED
5323271,1,1,1704297817,1704297817,1704297853,36,COMPLETED
5323272,1,1,1704297817,1704297817,1704297852,35,COMPLETED
5323273,1,1,1704297817,1704297818,1704297849,31,COMPLETED
5323274,1,1,1704297818,1704297818,1704297848,30,COMPLETED
5323275,1,1,1704297818,1704297818,1704297851,33,COMPLETED
5323276,1,1,1704297818,1704297818,1704297848,30,COMPLETED
5323277,1,1,1704297818,1704297818,1704297851,33,COMPLETED
5323278,1,1,1704297818,1704297818,1704297850,32,COMPLETED
5323279,1,1,1704297818,1704297818,1704297848,30,COMPLETED
5323280,1,1,1704297818,1704297818,1704297848,30,COMPLETED
5323281,1,1,1704297818,1704297818,1704297848,30,COMPLETED
5323282,1,1,1704297818,1704297818,1704297849,31,COMPLETED
5323283,1,1,1704297818,1704297818,1704297849,31,COMPLETED
5323284,1,1,1704297818,1704297818,1704297849,31,COMPLETED
5323285,1,1,1704297819,1704297819,1704297849,30,COMPLETED
5323286,1,1,1704297819,1704297819,1704297849,30,COMPLETED
5323287,1,1,1704297819,1704297819,1704297849,30,COMPLETED
5323288,1,1,1704297819,1704297819,1704297849,30,COMPLETED
5323289,1,1,1704297819,1704297819,1704297849,30,COMPLETED
5323290,1,1,1704297819,1704297819,1704297848,29,COMPLETED
5323291,1,1,1704297819,1704297819,1704297848,29,COMPLETED
5323292,1,1,1704297819,1704297819,1704297849,30,COMPLETED
5323293,1,1,1704297819,1704297819,1704297848,29,COMPLETED
5323294,1,1,1704297819,1704297819,1704297848,29,COMPLETED
5323295,1,1,1704297842,1704297842,1704297883,41,COMPLETED
5323296,1,1,1704297842,1704297842,1704297883,41,COMPLETED
5323297,1,1,1704297842,1704297842,1704297883,41,COMPLETED
5323298,1,1,1704297842,1704297842,1704297883,41,COMPLETED
5323299,1,1,1704297843,1704297846,1704297883,37,COMPLETED
5323300,1,1,1704297849,1704297850,1704297892,42,COMPLETED
5323301,1,1,1704297849,1704297850,1704297889,39,COMPLETED
5323302,1,1,1704297849,1704297850,1704297890,40,COMPLETED
5323303,1,1,1704297849,1704297850,1704297891,41,COMPLETED
5323304,1,1,1704297849,1704297850,1704297891,41,COMPLETED
5323305,1,1,1704297849,1704297850,1704297893,43,COMPLETED
5323306,1,1,1704297849,1704297850,1704297890,40,COMPLETED
5323307,1,1,1704297849,1704297850,1704297889,39,COMPLETED
5323308,1,1,1704297849,1704297850,1704297891,41,COMPLETED
5323309,1,1,1704297849,1704297850,1704297893,43,COMPLETED
5323310,1,1,1704297849,1704297850,1704297891,41,COMPLETED
5323311,1,1,1704297849,1704297850,1704297893,43,COMPLETED
5323312,1,1,1704297849,1704297850,1704297891,41,COMPLETED
5323313,1,1,1704297849,1704297850,1704297893,43,COMPLETED
5323314,1,1,1704297849,1704297850,1704297892,42,COMPLETED
5323315,1,1,1704297849,1704297850,1704297889,39,COMPLETED
5323316,1,1,1704297849,1704297850,1704297893,43,COMPLETED
5323317,1,1,1704297849,1704297850,1704297890,40,COMPLETED
5323318,1,1,1704297849,1704297850,1704297894,44,COMPLETED
5323319,1,1,1704297849,1704297850,1704297894,44,COMPLETED
5323320,1,1,1704297849,1704297850,1704297889,39,COMPLETED
5323321,1,1,1704297850,1704297850,1704297890,40,COMPLETED
5323322,1,1,1704297850,1704297850,1704297892,42,COMPLETED
5323323,1,1,1704297850,1704297850,1704297895,45,COMPLETED
5323324,1,1,1704297850,1704297850,1704297889,39,COMPLETED
5323325,1,1,1704297850,1704297850,1704297893,43,COMPLETED
5323326,1,1,1704297850,1704297850,1704297890,40,COMPLETED
5323327,1,1,1704297850,1704297850,1704297893,43,COMPLETED
5323328,1,1,1704297850,1704297850,1704297892,42,COMPLETED
5323329,1,1,1704297850,1704297850,1704297892,42,COMPLETED
5323330,1,1,1704297850,1704297850,1704297891,41,COMPLETED
5323331,1,1,1704297850,1704297850,1704297890,40,COMPLETED
5323332,1,1,1704297850,1704297850,1704297892,42,COMPLETED
5323333,1,1,1704297850,1704297850,1704297892,42,COMPLETED
5323334,1,1,1704297850,1704297850,1704297889,39,COMPLETED
5323335,1,1,1704297850,1704297850,1704297891,41,COMPLETED
5323336,1,1,1704297851,1704297851,1704297883,32,COMPLETED
5323337,1,1,1704297851,1704297851,1704297883,32,COMPLETED
5323338,1,1,1704297851,1704297851,1704297883,32,COMPLETED
5323339,1,1,1704297851,1704297851,1704297883,32,COMPLETED
5323340,1,1,1704297851,1704297851,1704297883,32,COMPLETED
5323341,1,1,1704297851,1704297851,1704297883,32,COMPLETED
5323342,1,1,1704297851,1704297851,1704297883,32,COMPLETED
5323343,1,1,1704297851,1704297851,1704297883,32,COMPLETED
5323344,1,1,1704297851,1704297851,1704297883,32,COMPLETED
5323345,1,1,1704297851,1704297851,1704297883,32,COMPLETED
5323346,1,1,1704297851,1704297851,1704297883,32,COMPLETED
5323347,1,1,1704297851,1704297851,1704297883,32,COMPLETED
5323348,1,1,1704297851,1704297851,1704297883,32,COMPLETED
5323349,1,1,1704297851,1704297851,1704297883,32,COMPLETED
5323350,1,1,1704297851,1704297851,1704297883,32,COMPLETED
5323351,1,1,1704297851,1704297851,1704297883,32,COMPLETED
5323352,1,1,1704297851,1704297852,1704297883,31,COMPLETED
5323353,1,1,1704297851,1704297852,1704297883,31,COMPLETED
5323355,1,1,1704297851,1704297852,1704297883,31,COMPLETED
5323354,1,1,1704297851,1704297852,1704297995,143,COMPLETED
5323356,1,1,1704297852,1704297852,1704297883,31,COMPLETED
5323357,1,1,1704297852,1704297852,1704297883,31,COMPLETED
5323358,1,1,1704297859,1704297859,1704297889,30,COMPLETED
5323359,1,1,1704297859,1704297859,1704297893,34,COMPLETED
5323360,1,1,1704297859,1704297859,1704297890,31,COMPLETED
5323361,1,1,1704297859,1704297859,1704297891,32,COMPLETED
5323362,1,1,1704297859,1704297859,1704297889,30,COMPLETED
5323363,1,1,1704297860,1704297860,1704297891,31,COMPLETED
5323364,1,1,1704297860,1704297860,1704297889,29,COMPLETED
5323365,1,1,1704297860,1704297860,1704297892,32,COMPLETED
5323366,1,1,1704297860,1704297860,1704297889,29,COMPLETED
5323367,1,1,1704297860,1704297860,1704297889,29,COMPLETED
5323368,1,1,1704297860,1704297860,1704297890,30,COMPLETED
5323369,1,1,1704297860,1704297860,1704297890,30,COMPLETED
5323370,1,1,1704297860,1704297860,1704297894,34,COMPLETED
5323371,1,1,1704297860,1704297860,1704297889,29,COMPLETED
5323372,1,1,1704297860,1704297860,1704297891,31,COMPLETED
5323373,1,1,1704297861,1704297863,1704297894,31,COMPLETED
5323374,1,1,1704297861,1704297863,1704297895,32,COMPLETED
5323375,1,1,1704297861,1704297863,1704297894,31,COMPLETED
5323376,1,1,1704297861,1704297863,1704297894,31,COMPLETED
5323377,1,1,1704297861,1704297863,1704297892,29,COMPLETED
5323378,1,1,1704297861,1704297863,1704297894,31,COMPLETED
5323379,1,1,1704297861,1704297863,1704297891,28,COMPLETED
5323380,1,1,1704297861,1704297863,1704297895,32,COMPLETED
5323381,1,1,1704297861,1704297863,1704297894,31,COMPLETED
5323382,1,1,1704297861,1704297863,1704297893,30,COMPLETED
5323383,1,1,1704297862,1704297863,1704297893,30,COMPLETED
5323384,1,1,1704297862,1704297863,1704297894,31,COMPLETED
5323385,1,1,1704297862,1704297863,1704297894,31,COMPLETED
5323386,1,1,1704297862,1704297863,1704297894,31,COMPLETED
5323387,1,1,1704297862,1704297863,1704297892,29,COMPLETED
5323388,1,1,1704297862,1704297863,1704297893,30,COMPLETED
5323389,1,1,1704297862,1704297863,1704297894,31,COMPLETED
5323390,1,1,1704297862,1704297863,1704297893,30,COMPLETED
5323391,1,1,1704297862,1704297863,1704297893,30,COMPLETED
5323392,1,1,1704297862,1704297863,1704297896,33,COMPLETED
5323393,1,1,1704297863,1704297863,1704297892,29,COMPLETED
5323394,1,1,1704297863,1704297863,1704297885,22,COMPLETED
5323395,1,1,1704297863,1704297863,1704297885,22,COMPLETED
5323396,1,1,1704297863,1704297863,1704297885,22,COMPLETED
5323397,1,1,1704297863,1704297863,1704297885,22,COMPLETED
5323398,1,1,1704297863,1704297863,1704297886,23,COMPLETED
5323399,1,1,1704297863,1704297863,1704297885,22,COMPLETED
5323400,1,1,1704297863,1704297863,1704297886,23,COMPLETED
5323401,1,1,1704297863,1704297863,1704297886,23,COMPLETED
5323402,1,1,1704297863,1704297863,1704297886,23,COMPLETED
5323403,1,1,1704297864,1704297867,1704297917,50,COMPLETED
5323404,1,1,1704297864,1704297867,1704297917,50,COMPLETED
5323405,1,1,1704297864,1704297867,1704297917,50,COMPLETED
5323406,1,1,1704297864,1704297867,1704297917,50,COMPLETED
5323407,1,1,1704297864,1704297867,1704297917,50,COMPLETED
5323408,1,1,1704297864,1704297867,1704297918,51,COMPLETED
5323409,1,1,1704297864,1704297867,1704297917,50,COMPLETED
5323410,1,1,1704297864,1704297867,1704297917,50,COMPLETED
5323411,1,1,1704297864,1704297867,1704297919,52,COMPLETED
5323412,1,1,1704297864,1704297867,1704297917,50,COMPLETED
5323413,1,1,1704297865,1704297867,1704297917,50,COMPLETED
5323414,1,1,1704297865,1704297867,1704297919,52,COMPLETED
5323415,1,1,1704297865,1704297867,1704297917,50,COMPLETED
5323416,1,1,1704297865,1704297867,1704297919,52,COMPLETED
5323417,1,1,1704297865,1704297867,1704297917,50,COMPLETED
5323418,1,1,1704297865,1704297867,1704297917,50,COMPLETED
5323419,1,1,1704297865,1704297867,1704297917,50,COMPLETED
5323420,1,1,1704297865,1704297867,1704297919,52,COMPLETED
5323421,1,1,1704297865,1704297867,1704297917,50,COMPLETED
5323422,1,1,1704297865,1704297867,1704297917,50,COMPLETED
5323423,1,1,1704297866,1704297867,1704297917,50,COMPLETED
5323424,1,1,1704297866,1704297867,1704297917,50,COMPLETED
5323425,1,1,1704297866,1704297867,1704297920,53,COMPLETED
5323426,1,1,1704297866,1704297867,1704297919,52,COMPLETED
5323427,1,1,1704297866,1704297867,1704297917,50,COMPLETED
5323428,1,1,1704297866,1704297867,1704297917,50,COMPLETED
5323429,1,1,1704297866,1704297867,1704297917,50,COMPLETED
5323430,1,1,1704297866,1704297867,1704297919,52,COMPLETED
5323431,1,1,1704297866,1704297867,1704297917,50,COMPLETED
5323432,1,1,1704297866,1704297867,1704297918,51,COMPLETED
5323433,1,1,1704297867,1704297867,1704297918,51,COMPLETED
5323434,1,1,1704297867,1704297867,1704297919,52,COMPLETED
5323435,1,1,1704297867,1704297867,1704297919,52,COMPLETED
5323436,1,1,1704297867,1704297867,1704297918,51,COMPLETED
5323437,1,1,1704297867,1704297867,1704297919,52,COMPLETED
5323438,1,1,1704297867,1704297867,1704297917,50,COMPLETED
5323439,1,1,1704297867,1704297867,1704297917,50,COMPLETED
5323440,1,1,1704297867,1704297871,1704297917,46,COMPLETED
5323441,1,1,1704297867,1704297871,1704297917,46,COMPLETED
5323442,1,1,1704297867,1704297871,1704297919,48,COMPLETED
5323443,1,1,1704297868,1704297871,1704297917,46,COMPLETED
5323444,1,1,1704297868,1704297871,1704297919,48,COMPLETED
5323445,1,1,1704297868,1704297871,1704297919,48,COMPLETED
5323446,1,1,1704297868,1704297871,1704297918,47,COMPLETED
5323447,1,1,1704297868,1704297871,1704297918,47,COMPLETED
5323448,1,1,1704297868,1704297871,1704297917,46,COMPLETED
5323449,1,1,1704297868,1704297871,1704297918,47,COMPLETED
5323450,1,1,1704297868,1704297871,1704297920,49,COMPLETED
5323451,1,1,1704297868,1704297871,1704297921,50,COMPLETED
5323452,1,1,1704297868,1704297871,1704297921,50,COMPLETED
5323453,1,1,1704297869,1704297871,1704297919,48,COMPLETED
5323454,1,1,1704297869,1704297871,1704297921,50,COMPLETED
5323455,1,1,1704297869,1704297871,1704297919,48,COMPLETED
5323456,1,1,1704297869,1704297871,1704297922,51,COMPLETED
5323457,1,1,1704297869,1704297871,1704297920,49,COMPLETED
5323458,1,1,1704297869,1704297871,1704297920,49,COMPLETED
5323459,1,1,1704297869,1704297871,1704297921,50,COMPLETED
5323460,1,1,1704297869,1704297871,1704297921,50,COMPLETED
5323461,1,1,1704297869,1704297871,1704297921,50,COMPLETED
5323462,1,1,1704297869,1704297871,1704297922,51,COMPLETED
5323463,1,1,1704297870,1704297871,1704297919,48,COMPLETED
5323464,1,1,1704297870,1704297871,1704297921,50,COMPLETED
5323465,1,1,1704297870,1704297871,1704297920,49,COMPLETED
5323466,1,1,1704297870,1704297871,1704297920,49,COMPLETED
5323467,1,1,1704297870,1704297871,1704297921,50,COMPLETED
5323468,1,1,1704297870,1704297871,1704297921,50,COMPLETED
5323469,1,1,1704297870,1704297871,1704297921,50,COMPLETED
5323470,1,1,1704297870,1704297871,1704297921,50,COMPLETED
5323471,1,1,1704297870,1704297871,1704297922,51,COMPLETED
5323472,1,1,1704297870,1704297871,1704297919,48,COMPLETED
5323473,1,1,1704297871,1704297871,1704297921,50,COMPLETED
5323474,1,1,1704297871,1704297871,1704297920,49,COMPLETED
5323475,1,1,1704297871,1704297871,1704297919,48,COMPLETED
5323476,1,1,1704297871,1704297871,1704297919,48,COMPLETED
5323477,1,1,1704297872,1704297875,1704297919,44,COMPLETED
5323478,1,1,1704297872,1704297875,1704297919,44,COMPLETED
5323479,1,1,1704297872,1704297875,1704297920,45,COMPLETED
5323480,1,1,1704297872,1704297875,1704297920,45,COMPLETED
5323481,1,1,1704297872,1704297875,1704297919,44,COMPLETED
5323482,1,1,1704297872,1704297875,1704297920,45,COMPLETED
5323483,1,1,1704297872,1704297875,1704297919,44,COMPLETED
5323484,1,1,1704297872,1704297875,1704297919,44,COMPLETED
5323485,72,2,1704297914,1704298047,1704298445,398,COMPLETED
5323486,36,1,1704297991,1704298043,1704299863,1820,TIMEOUT
5323487,1,1,1704298023,1704298023,1704298076,53,COMPLETED
5323488,1,1,1704298023,1704298023,1704298074,51,COMPLETED
5323489,1,1,1704298023,1704298023,1704298072,49,COMPLETED
5323490,1,1,1704298023,1704298023,1704298075,52,COMPLETED
5323491,1,1,1704298023,1704298023,1704298074,51,COMPLETED
5323492,1,1,1704298023,1704298023,1704298078,55,COMPLETED
5323493,1,1,1704298023,1704298023,1704298072,49,COMPLETED
5323494,1,1,1704298023,1704298023,1704298075,52,COMPLETED
5323495,1,1,1704298023,1704298023,1704298072,49,COMPLETED
5323496,1,1,1704298023,1704298023,1704298074,51,COMPLETED
5323497,1,1,1704298023,1704298023,1704298074,51,COMPLETED
5323498,1,1,1704298023,1704298023,1704298074,51,COMPLETED
5323499,1,1,1704298023,1704298023,1704298075,52,COMPLETED
5323500,1,1,1704298023,1704298023,1704298075,52,COMPLETED
5323501,1,1,1704298023,1704298023,1704298073,50,COMPLETED
5323502,1,1,1704298023,1704298023,1704298076,53,COMPLETED
5323503,1,1,1704298023,1704298023,1704298079,56,COMPLETED
5323504,1,1,1704298023,1704298023,1704298076,53,COMPLETED
5323505,1,1,1704298023,1704298023,1704298076,53,COMPLETED
5323506,1,1,1704298023,1704298023,1704298072,49,COMPLETED
5323507,1,1,1704298023,1704298023,1704298072,49,COMPLETED
5323508,1,1,1704298023,1704298023,1704298072,49,COMPLETED
5323509,1,1,1704298023,1704298023,1704298072,49,COMPLETED
5323510,1,1,1704298023,1704298023,1704298074,51,COMPLETED
5323511,1,1,1704298023,1704298023,1704298074,51,COMPLETED
5323512,1,1,1704298023,1704298023,1704298074,51,COMPLETED
5323513,1,1,1704298023,1704298023,1704298074,51,COMPLETED
5323514,1,1,1704298023,1704298023,1704298078,55,COMPLETED
5323515,1,1,1704298023,1704298023,1704298072,49,COMPLETED
5323516,1,1,1704298023,1704298023,1704298074,51,COMPLETED
5323517,1,1,1704298023,1704298023,1704298079,56,COMPLETED
5323518,1,1,1704298023,1704298023,1704298075,52,COMPLETED
5323519,1,1,1704298023,1704298023,1704298074,51,COMPLETED
5323520,1,1,1704298023,1704298023,1704298074,51,COMPLETED
5323521,1,1,1704298023,1704298023,1704298078,55,COMPLETED
5323522,1,1,1704298023,1704298027,1704298082,55,COMPLETED
5323523,1,1,1704298023,1704298027,1704298072,45,COMPLETED
5323524,1,1,1704298023,1704298027,1704298078,51,COMPLETED
5323525,1,1,1704298023,1704298027,1704298076,49,COMPLETED
5323526,1,1,1704298024,1704298027,1704298078,51,COMPLETED
5323527,1,1,1704298024,1704298027,1704298072,45,COMPLETED
5323528,1,1,1704298024,1704298027,1704298073,46,COMPLETED
5323529,1,1,1704298024,1704298027,1704298072,45,COMPLETED
5323530,1,1,1704298024,1704298027,1704298078,51,COMPLETED
5323531,1,1,1704298024,1704298027,1704298073,46,COMPLETED
5323532,1,1,1704298024,1704298027,1704298079,52,COMPLETED
5323533,1,1,1704298024,1704298027,1704298076,49,COMPLETED
5323534,1,1,1704298024,1704298027,1704298072,45,COMPLETED
5323535,1,1,1704298024,1704298027,1704298078,51,COMPLETED
5323536,1,1,1704298024,1704298027,1704298075,48,COMPLETED
5323537,1,1,1704298024,1704298027,1704298077,50,COMPLETED
5323538,1,1,1704298024,1704298027,1704298074,47,COMPLETED
5323539,1,1,1704298024,1704298027,1704298075,48,COMPLETED
5323540,1,1,1704298024,1704298027,1704298076,49,COMPLETED
5323541,1,1,1704298024,1704298027,1704298072,45,COMPLETED
5323542,1,1,1704298024,1704298027,1704298073,46,COMPLETED
5323543,1,1,1704298024,1704298027,1704298073,46,COMPLETED
5323544,1,1,1704298024,1704298027,1704298073,46,COMPLETED
5323545,1,1,1704298024,1704298027,1704298076,49,COMPLETED
5323546,1,1,1704298024,1704298027,1704298074,47,COMPLETED
5323547,1,1,1704298024,1704298027,1704298073,46,COMPLETED
5323548,1,1,1704298024,1704298027,1704298073,46,COMPLETED
5323549,1,1,1704298024,1704298027,1704298075,48,COMPLETED
5323550,1,1,1704298024,1704298027,1704298073,46,COMPLETED
5323551,1,1,1704298024,1704298027,1704298074,47,COMPLETED
5323552,1,1,1704298024,1704298027,1704298079,52,COMPLETED
5323553,1,1,1704298024,1704298027,1704298074,47,COMPLETED
5323554,1,1,1704298024,1704298027,1704298073,46,COMPLETED
5323555,1,1,1704298024,1704298027,1704298073,46,COMPLETED
5323556,1,1,1704298024,1704298027,1704298073,46,COMPLETED
5323557,1,1,1704298024,1704298027,1704298078,51,COMPLETED
5323558,1,1,1704298024,1704298027,1704298074,47,COMPLETED
5323559,1,1,1704298024,1704298027,1704298077,50,COMPLETED
5323560,1,1,1704298024,1704298027,1704298076,49,COMPLETED
5323561,1,1,1704298024,1704298027,1704298077,50,COMPLETED
5323562,1,1,1704298024,1704298027,1704298078,51,COMPLETED
5323563,1,1,1704298024,1704298027,1704298073,46,COMPLETED
5323564,1,1,1704298024,1704298027,1704298075,48,COMPLETED
5323565,1,1,1704298024,1704298027,1704298073,46,COMPLETED
5323566,1,1,1704298024,1704298027,1704298078,51,COMPLETED
5323567,1,1,1704298024,1704298027,1704298072,45,COMPLETED
5323568,1,1,1704298024,1704298027,1704298074,47,COMPLETED
5323569,1,1,1704298024,1704298027,1704298076,49,COMPLETED
5323570,1,1,1704298024,1704298027,1704298073,46,COMPLETED
5323571,1,1,1704298024,1704298027,1704298079,52,COMPLETED
5323572,1,1,1704298024,1704298027,1704298076,49,COMPLETED
5323573,1,1,1704298024,1704298027,1704298077,50,COMPLETED
5323574,1,1,1704298024,1704298027,1704298081,54,COMPLETED
5323575,1,1,1704298024,1704298027,1704298078,51,COMPLETED
5323576,1,1,1704298024,1704298027,1704298075,48,COMPLETED
5323577,1,1,1704298024,1704298027,1704298073,46,COMPLETED
5323578,1,1,1704298025,1704298027,1704298073,46,COMPLETED
5323579,1,1,1704298025,1704298027,1704298073,46,COMPLETED
5323580,1,1,1704298025,1704298027,1704298078,51,COMPLETED
5323581,1,1,1704298025,1704298027,1704298072,45,COMPLETED
5323582,1,1,1704298025,1704298027,1704298076,49,COMPLETED
5323583,1,1,1704298025,1704298027,1704298072,45,COMPLETED
5323584,1,1,1704298025,1704298027,1704298077,50,COMPLETED
5323585,1,1,1704298025,1704298027,1704298074,47,COMPLETED
5323586,1,1,1704298025,1704298027,1704298076,49,COMPLETED
5323587,1,1,1704298025,1704298027,1704298073,46,COMPLETED
5323588,1,1,1704298025,1704298027,1704298075,48,COMPLETED
5323589,1,1,1704298025,1704298027,1704298074,47,COMPLETED
5323590,1,1,1704298025,1704298027,1704298075,48,COMPLETED
5323591,1,1,1704298025,1704298027,1704298074,47,COMPLETED
5323592,1,1,1704298025,1704298027,1704298072,45,COMPLETED
5323593,1,1,1704298025,1704298027,1704298074,47,COMPLETED
5323594,1,1,1704298025,1704298027,1704298074,47,COMPLETED
5323595,1,1,1704298025,1704298027,1704298082,55,COMPLETED
5323596,1,1,1704298025,1704298027,1704298073,46,COMPLETED
5323597,1,1,1704298025,1704298027,1704298082,55,COMPLETED
5323598,1,1,1704298025,1704298027,1704298073,46,COMPLETED
5323599,1,1,1704298025,1704298027,1704298072,45,COMPLETED
5323600,1,1,1704298025,1704298027,1704298076,49,COMPLETED
5323601,1,1,1704298025,1704298027,1704298076,49,COMPLETED
5323602,1,1,1704298025,1704298027,1704298075,48,COMPLETED
5323603,1,1,1704298025,1704298027,1704298073,46,COMPLETED
5323604,1,1,1704298025,1704298027,1704298074,47,COMPLETED
5323605,1,1,1704298025,1704298027,1704298072,45,COMPLETED
5323606,1,1,1704298025,1704298027,1704298076,49,COMPLETED
5323607,1,1,1704298025,1704298027,1704298073,46,COMPLETED
5323608,1,1,1704298025,1704298027,1704298075,48,COMPLETED
5323609,1,1,1704298025,1704298027,1704298076,49,COMPLETED
5323610,1,1,1704298025,1704298027,1704298076,49,COMPLETED
5323611,1,1,1704298025,1704298027,1704298078,51,COMPLETED
5323612,1,1,1704298025,1704298027,1704298076,49,COMPLETED
5323613,1,1,1704298025,1704298027,1704298082,55,COMPLETED
5323614,1,1,1704298025,1704298027,1704298074,47,COMPLETED
5323615,1,1,1704298025,1704298027,1704298073,46,COMPLETED
5323616,1,1,1704298025,1704298027,1704298075,48,COMPLETED
5323617,1,1,1704298025,1704298027,1704298076,49,COMPLETED
5323618,1,1,1704298025,1704298027,1704298075,48,COMPLETED
5323619,1,1,1704298025,1704298027,1704298073,46,COMPLETED
5323620,1,1,1704298025,1704298027,1704298072,45,COMPLETED
5323621,1,1,1704298025,1704298027,1704298073,46,COMPLETED
5323622,1,1,1704298025,1704298027,1704298076,49,COMPLETED
5323623,1,1,1704298025,1704298027,1704298075,48,COMPLETED
5323624,1,1,1704298025,1704298027,1704298073,46,COMPLETED
5323625,1,1,1704298025,1704298027,1704298075,48,COMPLETED
5323626,1,1,1704298025,1704298027,1704298076,49,COMPLETED
5323627,1,1,1704298025,1704298027,1704298072,45,COMPLETED
5323628,1,1,1704298025,1704298027,1704298073,46,COMPLETED
5323629,1,1,1704298025,1704298027,1704298078,51,COMPLETED
5323630,1,1,1704298025,1704298027,1704298075,48,COMPLETED
5323631,1,1,1704298025,1704298027,1704298073,46,COMPLETED
5323632,1,1,1704298025,1704298027,1704298074,47,COMPLETED
5323633,1,1,1704298025,1704298027,1704298073,46,COMPLETED
5323634,1,1,1704298025,1704298027,1704298072,45,COMPLETED
5323635,1,1,1704298025,1704298027,1704298073,46,COMPLETED
5323636,1,1,1704298025,1704298027,1704298074,47,COMPLETED
5323637,1,1,1704298026,1704298027,1704298073,46,COMPLETED
5323638,1,1,1704298026,1704298027,1704298075,48,COMPLETED
5323639,1,1,1704298026,1704298027,1704298072,45,COMPLETED
5323640,1,1,1704298026,1704298027,1704298073,46,COMPLETED
5323641,1,1,1704298026,1704298027,1704298072,45,COMPLETED
5323642,1,1,1704298026,1704298027,1704298073,46,COMPLETED
5323643,1,1,1704298026,1704298027,1704298081,54,COMPLETED
5323644,1,1,1704298026,1704298027,1704298077,50,COMPLETED
5323645,1,1,1704298026,1704298027,1704298072,45,COMPLETED
5323646,1,1,1704298026,1704298027,1704298074,47,COMPLETED
5323647,1,1,1704298026,1704298027,1704298073,46,COMPLETED
5323648,1,1,1704298026,1704298027,1704298073,46,COMPLETED
5323649,1,1,1704298026,1704298027,1704298081,54,COMPLETED
5323650,1,1,1704298026,1704298027,1704298074,47,COMPLETED
5323651,1,1,1704298026,1704298027,1704298077,50,COMPLETED
5323652,1,1,1704298026,1704298027,1704298074,47,COMPLETED
5323653,1,1,1704298026,1704298027,1704298073,46,COMPLETED
5323654,1,1,1704298026,1704298027,1704298072,45,COMPLETED
5323655,1,1,1704298026,1704298027,1704298074,47,COMPLETED
5323656,1,1,1704298026,1704298027,1704298072,45,COMPLETED
5323657,1,1,1704298026,1704298027,1704298076,49,COMPLETED
5323658,1,1,1704298026,1704298027,1704298081,54,COMPLETED
5323659,1,1,1704298026,1704298027,1704298078,51,COMPLETED
5323660,1,1,1704298026,1704298027,1704298073,46,COMPLETED
5323661,1,1,1704298026,1704298027,1704298073,46,COMPLETED
5323662,1,1,1704298026,1704298027,1704298072,45,COMPLETED
5323663,1,1,1704298026,1704298027,1704298073,46,COMPLETED
5323664,1,1,1704298026,1704298027,1704298072,45,COMPLETED
5323665,1,1,1704298026,1704298027,1704298083,56,COMPLETED
5323666,1,1,1704298026,1704298027,1704298081,54,COMPLETED
5323667,1,1,1704298026,1704298027,1704298075,48,COMPLETED
5323668,1,1,1704298026,1704298027,1704298072,45,COMPLETED
5323669,1,1,1704298026,1704298027,1704298078,51,COMPLETED
5323670,1,1,1704298026,1704298027,1704298078,51,COMPLETED
5323671,1,1,1704298026,1704298027,1704298072,45,COMPLETED
5323672,1,1,1704298026,1704298027,1704298073,46,COMPLETED
5323673,1,1,1704298026,1704298027,1704298072,45,COMPLETED
5323674,1,1,1704298026,1704298027,1704298073,46,COMPLETED
5323675,1,1,1704298026,1704298027,1704298082,55,COMPLETED
5323676,1,1,1704298026,1704298027,1704298072,45,COMPLETED
5323677,1,1,1704298026,1704298027,1704298072,45,COMPLETED
5323678,1,1,1704298026,1704298027,1704298072,45,COMPLETED
5323679,1,1,1704298026,1704298027,1704298072,45,COMPLETED
5323680,1,1,1704298026,1704298027,1704298079,52,COMPLETED
5323681,1,1,1704298026,1704298027,1704298072,45,COMPLETED
5323682,1,1,1704298026,1704298027,1704298072,45,COMPLETED
5323683,1,1,1704298026,1704298027,1704298072,45,COMPLETED
5323684,1,1,1704298026,1704298027,1704298072,45,COMPLETED
5323685,1,1,1704298026,1704298027,1704298072,45,COMPLETED
5323686,1,1,1704298026,1704298027,1704298073,46,COMPLETED
5323687,1,1,1704298073,1704298073,1704298106,33,COMPLETED
5323688,1,1,1704298073,1704298073,1704298107,34,COMPLETED
5323689,1,1,1704298074,1704298074,1704298108,34,COMPLETED
5323690,1,1,1704298074,1704298074,1704298107,33,COMPLETED
5323691,1,1,1704298074,1704298074,1704298106,32,COMPLETED
5323692,1,1,1704298074,1704298074,1704298108,34,COMPLETED
5323693,1,1,1704298074,1704298074,1704298107,33,COMPLETED
5323694,1,1,1704298074,1704298074,1704298107,33,COMPLETED
5323695,1,1,1704298075,1704298075,1704298107,32,COMPLETED
5323696,1,1,1704298075,1704298075,1704298106,31,COMPLETED
5323697,1,1,1704298075,1704298075,1704298107,32,COMPLETED
5323698,1,1,1704298075,1704298075,1704298108,33,COMPLETED
5323699,1,1,1704298075,1704298075,1704298106,31,COMPLETED
5323700,1,1,1704298075,1704298075,1704298107,32,COMPLETED
5323701,1,1,1704298076,1704298076,1704298108,32,COMPLETED
5323702,1,1,1704298076,1704298076,1704298106,30,COMPLETED
5323703,1,1,1704298076,1704298076,1704298107,31,COMPLETED
5323704,1,1,1704298076,1704298076,1704298104,28,COMPLETED
5323705,1,1,1704298076,1704298076,1704298104,28,COMPLETED
5323706,1,1,1704298076,1704298076,1704298104,28,COMPLETED
5323707,1,1,1704298076,1704298076,1704298104,28,COMPLETED
5323708,1,1,1704298077,1704298077,1704298104,27,COMPLETED
5323709,1,1,1704298077,1704298077,1704298104,27,COMPLETED
5323710,1,1,1704298077,1704298077,1704298104,27,COMPLETED
5323711,1,1,1704298077,1704298077,1704298105,28,COMPLETED
5323712,1,1,1704298077,1704298077,1704298104,27,COMPLETED
5323713,1,1,1704298077,1704298077,1704298104,27,COMPLETED
5323714,1,1,1704298077,1704298077,1704298104,27,COMPLETED
5323715,1,1,1704298078,1704298078,1704298104,26,COMPLETED
5323716,1,1,1704298078,1704298078,1704298104,26,COMPLETED
5323717,1,1,1704298078,1704298078,1704298104,26,COMPLETED
5323718,1,1,1704298078,1704298078,1704298108,30,COMPLETED
5323719,1,1,1704298078,1704298078,1704298107,29,COMPLETED
5323720,1,1,1704298078,1704298078,1704298106,28,COMPLETED
5323721,1,1,1704298078,1704298078,1704298108,30,COMPLETED
5323722,1,1,1704298078,1704298078,1704298106,28,COMPLETED
5323723,1,1,1704298078,1704298078,1704298107,29,COMPLETED
5323724,1,1,1704298090,1704298090,1704298107,17,COMPLETED
5323725,1,1,1704298090,1704298090,1704298107,17,COMPLETED
5323726,1,1,1704298091,1704298094,1704298131,37,COMPLETED
5323727,1,1,1704298091,1704298094,1704298132,38,COMPLETED
5323728,1,1,1704298091,1704298094,1704298131,37,COMPLETED
5323729,1,1,1704298091,1704298094,1704298131,37,COMPLETED
5323730,1,1,1704298091,1704298094,1704298131,37,COMPLETED
5323731,1,1,1704298091,1704298094,1704298132,38,COMPLETED
5323732,1,1,1704298091,1704298094,1704298132,38,COMPLETED
5323733,1,1,1704298091,1704298094,1704298131,37,COMPLETED
5323734,1,1,1704298091,1704298094,1704298132,38,COMPLETED
5323735,1,1,1704298091,1704298094,1704298132,38,COMPLETED
5323736,1,1,1704298092,1704298094,1704298131,37,COMPLETED
5323737,1,1,1704298092,1704298094,1704298131,37,COMPLETED
5323738,1,1,1704298092,1704298094,1704298131,37,COMPLETED
5323739,1,1,1704298092,1704298094,1704298131,37,COMPLETED
5323740,1,1,1704298092,1704298094,1704298132,38,COMPLETED
5323741,1,1,1704298092,1704298094,1704298132,38,COMPLETED
5323742,1,1,1704298092,1704298094,1704298132,38,COMPLETED
5323743,1,1,1704298092,1704298094,1704298131,37,COMPLETED
5323744,1,1,1704298092,1704298094,1704298131,37,COMPLETED
5323745,1,1,1704298092,1704298094,1704298132,38,COMPLETED
5323746,1,1,1704298093,1704298094,1704298132,38,COMPLETED
5323747,1,1,1704298093,1704298094,1704298133,39,COMPLETED
5323748,1,1,1704298093,1704298094,1704298132,38,COMPLETED
5323749,1,1,1704298093,1704298094,1704298132,38,COMPLETED
5323750,1,1,1704298093,1704298094,1704298133,39,COMPLETED
5323751,1,1,1704298093,1704298094,1704298133,39,COMPLETED
5323752,1,1,1704298093,1704298094,1704298131,37,COMPLETED
5323753,1,1,1704298093,1704298094,1704298137,43,COMPLETED
5323754,1,1,1704298093,1704298094,1704298131,37,COMPLETED
5323755,1,1,1704298093,1704298094,1704298137,43,COMPLETED
5323756,1,1,1704298094,1704298094,1704298133,39,COMPLETED
5323757,1,1,1704298094,1704298094,1704298132,38,COMPLETED
5323758,1,1,1704298094,1704298094,1704298132,38,COMPLETED
5323759,1,1,1704298094,1704298094,1704298133,39,COMPLETED
5323760,1,1,1704298094,1704298094,1704298132,38,COMPLETED
5323761,1,1,1704298094,1704298094,1704298131,37,COMPLETED
5323762,1,1,1704298094,1704298094,1704298142,48,COMPLETED
5323763,1,1,1704298094,1704298094,1704298131,37,COMPLETED
5323764,1,1,1704298094,1704298094,1704298131,37,COMPLETED
5323765,1,1,1704298094,1704298094,1704298132,38,COMPLETED
5323766,1,1,1704298095,1704298098,1704298142,44,COMPLETED
5323767,1,1,1704298095,1704298098,1704298148,50,COMPLETED
5323768,1,1,1704298095,1704298098,1704298142,44,COMPLETED
5323769,1,1,1704298095,1704298098,1704298142,44,COMPLETED
5323770,1,1,1704298095,1704298098,1704298143,45,COMPLETED
5323771,1,1,1704298096,1704298098,1704298142,44,COMPLETED
5323772,1,1,1704298096,1704298098,1704298142,44,COMPLETED
5323773,1,1,1704298096,1704298098,1704298142,44,COMPLETED
5323774,1,1,1704298096,1704298098,1704298151,53,COMPLETED
5323775,1,1,1704298096,1704298098,1704298142,44,COMPLETED
5323776,1,1,1704298096,1704298098,1704298142,44,COMPLETED
5323777,1,1,1704298096,1704298098,1704298142,44,COMPLETED
5323778,1,1,1704298096,1704298098,1704298143,45,COMPLETED
5323779,1,1,1704298096,1704298098,1704298142,44,COMPLETED
5323780,1,1,1704298096,1704298098,1704298142,44,COMPLETED
5323781,1,1,1704298096,1704298098,1704298142,44,COMPLETED
5323782,1,1,1704298096,1704298098,1704298147,49,COMPLETED
5323783,1,1,1704298096,1704298098,1704298147,49,COMPLETED
5323784,1,1,1704298096,1704298098,1704298149,51,COMPLETED
5323785,1,1,1704298096,1704298098,1704298148,50,COMPLETED
5323786,1,1,1704298097,1704298098,1704298149,51,COMPLETED
5323787,1,1,1704298097,1704298098,1704298150,52,COMPLETED
5323788,1,1,1704298097,1704298098,1704298147,49,COMPLETED
5323789,1,1,1704298098,1704298098,1704298144,46,COMPLETED
5323790,1,1,1704298098,1704298098,1704298146,48,COMPLETED
5323791,1,1,1704298098,1704298098,1704298146,48,COMPLETED
5323792,1,1,1704298098,1704298098,1704298148,50,COMPLETED
5323793,1,1,1704298098,1704298098,1704298149,51,COMPLETED
5323794,1,1,1704298098,1704298098,1704298146,48,COMPLETED
5323795,1,1,1704298098,1704298098,1704298148,50,COMPLETED
5323796,1,1,1704298098,1704298098,1704298145,47,COMPLETED
5323797,1,1,1704298098,1704298098,1704298148,50,COMPLETED
5323798,1,1,1704298098,1704298098,1704298145,47,COMPLETED
5323799,1,1,1704298098,1704298098,1704298146,48,COMPLETED
5323800,1,1,1704298098,1704298098,1704298148,50,COMPLETED
5323801,1,1,1704298098,1704298098,1704298148,50,COMPLETED
5323802,1,1,1704298098,1704298098,1704298149,51,COMPLETED
5323803,1,1,1704298098,1704298098,1704298147,49,COMPLETED
5323804,1,1,1704298099,1704298102,1704298147,45,COMPLETED
5323805,1,1,1704298099,1704298102,1704298148,46,COMPLETED
5323806,1,1,1704298099,1704298102,1704298149,47,COMPLETED
5323807,1,1,1704298099,1704298102,1704298147,45,COMPLETED
5323808,1,1,1704298099,1704298102,1704298143,41,COMPLETED
5323809,1,1,1704298099,1704298102,1704298148,46,COMPLETED
5323810,1,1,1704298099,1704298102,1704298145,43,COMPLETED
5323811,1,1,1704298099,1704298102,1704298149,47,COMPLETED
5323812,1,1,1704298099,1704298102,1704298148,46,COMPLETED
5323813,1,1,1704298099,1704298102,1704298146,44,COMPLETED
5323814,1,1,1704298099,1704298102,1704298151,49,COMPLETED
5323815,1,1,1704298100,1704298102,1704298147,45,COMPLETED
5323816,1,1,1704298100,1704298102,1704298148,46,COMPLETED
5323817,1,1,1704298100,1704298102,1704298148,46,COMPLETED
5323818,1,1,1704298100,1704298102,1704298149,47,COMPLETED
5323819,1,1,1704298100,1704298102,1704298145,43,COMPLETED
5323820,1,1,1704298100,1704298102,1704298144,42,COMPLETED
5323821,1,1,1704298100,1704298102,1704298144,42,COMPLETED
5323822,1,1,1704298100,1704298102,1704298145,43,COMPLETED
5323823,1,1,1704298100,1704298102,1704298146,44,COMPLETED
5323824,1,1,1704298101,1704298102,1704298148,46,COMPLETED
5323825,1,1,1704298101,1704298102,1704298145,43,COMPLETED
5323826,1,1,1704298101,1704298102,1704298144,42,COMPLETED
5323827,1,1,1704298101,1704298102,1704298151,49,COMPLETED
5323828,1,1,1704298101,1704298102,1704298147,45,COMPLETED
5323829,1,1,1704298101,1704298102,1704298147,45,COMPLETED
5323830,1,1,1704298101,1704298102,1704298146,44,COMPLETED
5323831,1,1,1704298101,1704298102,1704298147,45,COMPLETED
5323832,1,1,1704298101,1704298102,1704298149,47,COMPLETED
5323833,1,1,1704298101,1704298102,1704298146,44,COMPLETED
5323834,1,1,1704298102,1704298102,1704298148,46,COMPLETED
5323835,1,1,1704298102,1704298102,1704298146,44,COMPLETED
5323836,1,1,1704298102,1704298102,1704298144,42,COMPLETED
5323837,1,1,1704298102,1704298102,1704298148,46,COMPLETED
5323838,1,1,1704298102,1704298102,1704298146,44,COMPLETED
5323839,1,1,1704298102,1704298102,1704298149,47,COMPLETED
5323840,1,1,1704298102,1704298102,1704298150,48,COMPLETED
5323841,1,1,1704298102,1704298102,1704298148,46,COMPLETED
5323842,1,1,1704298102,1704298102,1704298147,45,COMPLETED
5323843,1,1,1704298102,1704298102,1704298146,44,COMPLETED
5323844,1,1,1704298103,1704298103,1704298150,47,COMPLETED
5323845,1,1,1704298103,1704298103,1704298146,43,COMPLETED
5323846,1,1,1704298103,1704298103,1704298146,43,COMPLETED
5323847,1,1,1704298103,1704298103,1704298144,41,COMPLETED
5323848,1,1,1704298103,1704298103,1704298146,43,COMPLETED
5323849,1,1,1704298103,1704298103,1704298147,44,COMPLETED
5323850,1,1,1704298103,1704298103,1704298150,47,COMPLETED
5323851,1,1,1704298103,1704298103,1704298146,43,COMPLETED
5323852,1,1,1704298103,1704298103,1704298149,46,COMPLETED
5323853,1,1,1704298103,1704298103,1704298146,43,COMPLETED
5323854,1,1,1704298104,1704298105,1704298143,38,COMPLETED
5323855,1,1,1704298104,1704298105,1704298148,43,COMPLETED
5323856,1,1,1704298104,1704298105,1704298144,39,COMPLETED
5323857,1,1,1704298104,1704298105,1704298146,41,COMPLETED
5323858,1,1,1704298104,1704298105,1704298147,42,COMPLETED
5323859,1,1,1704298104,1704298105,1704298147,42,COMPLETED
5323860,1,1,1704298104,1704298105,1704298147,42,COMPLETED
5323861,1,1,1704298104,1704298105,1704298148,43,COMPLETED
5323862,1,1,1704298104,1704298105,1704298148,43,COMPLETED
5323863,1,1,1704298104,1704298105,1704298148,43,COMPLETED
5323864,1,1,1704298105,1704298105,1704298145,40,COMPLETED
5323865,1,1,1704298105,1704298105,1704298142,37,COMPLETED
5323866,1,1,1704298105,1704298105,1704298147,42,COMPLETED
5323867,1,1,1704298105,1704298105,1704298147,42,COMPLETED
5323868,1,1,1704298105,1704298105,1704298148,43,COMPLETED
5323869,1,1,1704298105,1704298105,1704298149,44,COMPLETED
5323870,1,1,1704298105,1704298105,1704298149,44,COMPLETED
5323871,1,1,1704298105,1704298105,1704298148,43,COMPLETED
5323872,1,1,1704298105,1704298105,1704298149,44,COMPLETED
5323873,1,1,1704298105,1704298105,1704298148,43,COMPLETED
5323874,1,1,1704298106,1704298106,1704298144,38,COMPLETED
5323875,1,1,1704298106,1704298106,1704298144,38,COMPLETED
5323876,1,1,1704298106,1704298106,1704298142,36,COMPLETED
5323877,1,1,1704298106,1704298106,1704298151,45,COMPLETED
5323878,1,1,1704298106,1704298106,1704298146,40,COMPLETED
5323879,1,1,1704298106,1704298106,1704298147,41,COMPLETED
5323880,1,1,1704298106,1704298107,1704298146,39,COMPLETED
5323881,1,1,1704298106,1704298107,1704298148,41,COMPLETED
5323882,1,1,1704298106,1704298107,1704298147,40,COMPLETED
5323883,1,1,1704298106,1704298107,1704298147,40,COMPLETED
5323884,1,1,1704298107,1704298107,1704298145,38,COMPLETED
5323885,1,1,1704298107,1704298107,1704298149,42,COMPLETED
5323886,1,1,1704298107,1704298107,1704298147,40,COMPLETED
5323887,1,1,1704298107,1704298107,1704298144,37,COMPLETED
5323888,1,1,1704298107,1704298107,1704298149,42,COMPLETED
5323889,1,1,1704298107,1704298107,1704298147,40,COMPLETED
5323890,1,1,1704298107,1704298107,1704298135,28,COMPLETED
5323891,1,1,1704298107,1704298107,1704298135,28,COMPLETED
5323892,1,1,1704298108,1704298108,1704298135,27,COMPLETED
5323893,1,1,1704298108,1704298108,1704298135,27,COMPLETED
5323894,1,1,1704298118,1704298119,1704298173,54,COMPLETED
5323895,1,1,1704298118,1704298119,1704298175,56,COMPLETED
5323896,1,1,1704298134,1704298134,1704298176,42,COMPLETED
5323897,1,1,1704298134,1704298134,1704298175,41,COMPLETED
5323898,1,1,1704298135,1704298135,1704298171,36,COMPLETED
5323899,1,1,1704298135,1704298135,1704298170,35,COMPLETED
5323900,1,1,1704298135,1704298135,1704298170,35,COMPLETED
5323901,1,1,1704298135,1704298135,1704298170,35,COMPLETED
5323902,1,1,1704298135,1704298135,1704298170,35,COMPLETED
5323903,1,1,1704298135,1704298136,1704298171,35,COMPLETED
5323904,1,1,1704298135,1704298136,1704298170,34,COMPLETED
5323905,1,1,1704298135,1704298136,1704298170,34,COMPLETED
5323906,1,1,1704298135,1704298136,1704298172,36,COMPLETED
5323907,1,1,1704298135,1704298136,1704298169,33,COMPLETED
5323908,1,1,1704298136,1704298136,1704298170,34,COMPLETED
5323909,1,1,1704298136,1704298136,1704298169,33,COMPLETED
5323910,1,1,1704298136,1704298136,1704298171,35,COMPLETED
5323911,1,1,1704298136,1704298138,1704298176,38,COMPLETED
5323912,1,1,1704298136,1704298138,1704298175,37,COMPLETED
5323913,1,1,1704298136,1704298138,1704298176,38,COMPLETED
5323914,1,1,1704298136,1704298138,1704298176,38,COMPLETED
5323915,1,1,1704298136,1704298138,1704298177,39,COMPLETED
5323916,1,1,1704298136,1704298138,1704298177,39,COMPLETED
5323917,1,1,1704298137,1704298138,1704298177,39,COMPLETED
5323918,1,1,1704298137,1704298138,1704298177,39,COMPLETED
5323919,1,1,1704298137,1704298138,1704298177,39,COMPLETED
5323920,1,1,1704298137,1704298138,1704298173,35,COMPLETED
5323921,1,1,1704298137,1704298138,1704298176,38,COMPLETED
5323922,1,1,1704298137,1704298138,1704298175,37,COMPLETED
5323923,1,1,1704298137,1704298138,1704298177,39,COMPLETED
5323924,1,1,1704298137,1704298138,1704298177,39,COMPLETED
5323925,1,1,1704298137,1704298138,1704298176,38,COMPLETED
5323926,1,1,1704298137,1704298138,1704298178,40,COMPLETED
5323927,1,1,1704298137,1704298138,1704298175,37,COMPLETED
5323928,1,1,1704298149,1704298149,1704298176,27,COMPLETED
5323929,1,1,1704298149,1704298149,1704298177,28,COMPLETED
5323930,1,1,1704298149,1704298149,1704298177,28,COMPLETED
5323931,1,1,1704298149,1704298149,1704298177,28,COMPLETED
5323932,1,1,1704298149,1704298149,1704298176,27,COMPLETED
5323933,1,1,1704298149,1704298149,1704298176,27,COMPLETED
5323934,1,1,1704298150,1704298150,1704298177,27,COMPLETED
5323935,1,1,1704298150,1704298150,1704298178,28,COMPLETED
5323936,1,1,1704298150,1704298150,1704298178,28,COMPLETED
5323937,1,1,1704298150,1704298150,1704298178,28,COMPLETED
5323938,1,1,1704298150,1704298150,1704298177,27,COMPLETED
5323939,1,1,1704298150,1704298150,1704298178,28,COMPLETED
5323940,1,1,1704298150,1704298150,1704298179,29,COMPLETED
5323941,1,1,1704298150,1704298150,1704298178,28,COMPLETED
5323942,1,1,1704298150,1704298150,1704298177,27,COMPLETED
5323943,1,1,1704298150,1704298150,1704298172,22,COMPLETED
5323944,1,1,1704298151,1704298151,1704298169,18,COMPLETED
5323945,1,1,1704298151,1704298151,1704298169,18,COMPLETED
5323946,1,1,1704298151,1704298151,1704298169,18,COMPLETED
5323947,1,1,1704298151,1704298151,1704298169,18,COMPLETED
5323948,1,1,1704298151,1704298151,1704298169,18,COMPLETED
5323949,1,1,1704298151,1704298151,1704298169,18,COMPLETED
5323950,1,1,1704298151,1704298151,1704298169,18,COMPLETED
5323951,1,1,1704298151,1704298151,1704298170,19,COMPLETED
5323952,1,1,1704298151,1704298151,1704298171,20,COMPLETED
5323953,1,1,1704298151,1704298151,1704298170,19,COMPLETED
5323954,1,1,1704298152,1704298152,1704298171,19,COMPLETED
5323955,1,1,1704298152,1704298152,1704298172,20,COMPLETED
5323956,1,1,1704298152,1704298152,1704298171,19,COMPLETED
5323957,1,1,1704298152,1704298152,1704298171,19,COMPLETED
5323958,1,1,1704298152,1704298153,1704298177,24,COMPLETED
5323959,1,1,1704298152,1704298153,1704298177,24,COMPLETED
5323960,1,1,1704298152,1704298153,1704298178,25,COMPLETED
5323961,1,1,1704298152,1704298153,1704298178,25,COMPLETED
5323962,1,1,1704298152,1704298153,1704298176,23,COMPLETED
5323963,1,1,1704298152,1704298153,1704298176,23,COMPLETED
5323964,1,1,1704298153,1704298153,1704298177,24,COMPLETED
5323965,1,1,1704298153,1704298153,1704298178,25,COMPLETED
5323966,1,1,1704298153,1704298153,1704298177,24,COMPLETED
5323967,1,1,1704298153,1704298153,1704298177,24,COMPLETED
5323968,1,1,1704298153,1704298153,1704298176,23,COMPLETED
5323969,1,1,1704298153,1704298153,1704298178,25,COMPLETED
5323970,1,1,1704298153,1704298153,1704298176,23,COMPLETED
5323971,1,1,1704298153,1704298153,1704298177,24,COMPLETED
5323972,1,1,1704298153,1704298153,1704298178,25,COMPLETED
5323973,1,1,1704298153,1704298153,1704298176,23,COMPLETED
5323974,1,1,1704298154,1704298157,1704298203,46,COMPLETED
5323975,1,1,1704298154,1704298157,1704298200,43,COMPLETED
5323976,1,1,1704298154,1704298157,1704298201,44,COMPLETED
5323977,1,1,1704298154,1704298157,1704298201,44,COMPLETED
5323978,1,1,1704298154,1704298157,1704298200,43,COMPLETED
5323979,1,1,1704298154,1704298157,1704298201,44,COMPLETED
5323980,1,1,1704298154,1704298157,1704298200,43,COMPLETED
5323981,1,1,1704298154,1704298157,1704298200,43,COMPLETED
5323982,1,1,1704298154,1704298157,1704298201,44,COMPLETED
5323983,1,1,1704298154,1704298157,1704298201,44,COMPLETED
5323984,1,1,1704298155,1704298157,1704298201,44,COMPLETED
5323985,1,1,1704298155,1704298157,1704298199,42,COMPLETED
5323986,1,1,1704298155,1704298157,1704298203,46,COMPLETED
5323987,1,1,1704298155,1704298157,1704298203,46,COMPLETED
5323988,1,1,1704298155,1704298157,1704298201,44,COMPLETED
5323989,1,1,1704298155,1704298157,1704298201,44,COMPLETED
5323990,1,1,1704298155,1704298157,1704298205,48,COMPLETED
5323991,1,1,1704298155,1704298157,1704298199,42,COMPLETED
5323992,1,1,1704298155,1704298157,1704298200,43,COMPLETED
5323993,1,1,1704298155,1704298157,1704298200,43,COMPLETED
5323994,1,1,1704298156,1704298157,1704298203,46,COMPLETED
5323995,1,1,1704298156,1704298157,1704298201,44,COMPLETED
5323996,1,1,1704298156,1704298157,1704298204,47,COMPLETED
5323997,1,1,1704298156,1704298157,1704298203,46,COMPLETED
5323998,1,1,1704298156,1704298157,1704298205,48,COMPLETED
5323999,1,1,1704298156,1704298157,1704298202,45,COMPLETED
5324000,1,1,1704298156,1704298157,1704298205,48,COMPLETED
5324001,1,1,1704298156,1704298157,1704298203,46,COMPLETED
5324002,1,1,1704298156,1704298157,1704298203,46,COMPLETED
5324003,1,1,1704298156,1704298157,1704298204,47,COMPLETED
5324004,1,1,1704298157,1704298157,1704298204,47,COMPLETED
5324005,1,1,1704298157,1704298157,1704298203,46,COMPLETED
5324006,1,1,1704298157,1704298157,1704298201,44,COMPLETED
5324007,1,1,1704298157,1704298157,1704298204,47,COMPLETED
5324008,1,1,1704298157,1704298157,1704298203,46,COMPLETED
5324009,1,1,1704298157,1704298157,1704298204,47,COMPLETED
5324010,1,1,1704298157,1704298157,1704298204,47,COMPLETED
5324011,1,1,1704298157,1704298157,1704298204,47,COMPLETED
5324012,1,1,1704298157,1704298157,1704298204,47,COMPLETED
5324013,1,1,1704298157,1704298157,1704298205,48,COMPLETED
5324014,1,1,1704298158,1704298161,1704298204,43,COMPLETED
5324015,1,1,1704298158,1704298161,1704298203,42,COMPLETED
5324016,1,1,1704298158,1704298161,1704298203,42,COMPLETED
5324017,1,1,1704298158,1704298161,1704298204,43,COMPLETED
5324018,1,1,1704298158,1704298161,1704298203,42,COMPLETED
5324019,1,1,1704298158,1704298161,1704298203,42,COMPLETED
5324020,1,1,1704298158,1704298161,1704298203,42,COMPLETED
5324021,1,1,1704298158,1704298161,1704298199,38,COMPLETED
5324022,1,1,1704298158,1704298161,1704298200,39,COMPLETED
5324023,1,1,1704298158,1704298161,1704298200,39,COMPLETED
5324024,1,1,1704298159,1704298161,1704298200,39,COMPLETED
5324025,1,1,1704298159,1704298161,1704298199,38,COMPLETED
5324026,1,1,1704298159,1704298161,1704298201,40,COMPLETED
5324027,1,1,1704298159,1704298161,1704298201,40,COMPLETED
5324028,1,1,1704298159,1704298161,1704298200,39,COMPLETED
5324029,1,1,1704298159,1704298161,1704298200,39,COMPLETED
5324030,1,1,1704298159,1704298161,1704298200,39,COMPLETED
5324031,1,1,1704298159,1704298161,1704298203,42,COMPLETED
5324032,1,1,1704298159,1704298161,1704298200,39,COMPLETED
5324033,1,1,1704298159,1704298161,1704298199,38,COMPLETED
5324034,1,1,1704298160,1704298161,1704298200,39,COMPLETED
5324035,1,1,1704298160,1704298161,1704298199,38,COMPLETED
5324036,1,1,1704298160,1704298161,1704298201,40,COMPLETED
5324037,1,1,1704298160,1704298161,1704298199,38,COMPLETED
5324038,1,1,1704298160,1704298161,1704298206,45,COMPLETED
5324039,1,1,1704298160,1704298161,1704298208,47,COMPLETED
5324040,1,1,1704298160,1704298161,1704298208,47,COMPLETED
5324041,1,1,1704298160,1704298161,1704298208,47,COMPLETED
5324042,1,1,1704298160,1704298161,1704298208,47,COMPLETED
5324043,1,1,1704298160,1704298161,1704298206,45,COMPLETED
5324044,1,1,1704298161,1704298161,1704298207,46,COMPLETED
5324045,1,1,1704298161,1704298163,1704298206,43,COMPLETED
5324046,1,1,1704298161,1704298163,1704298208,45,COMPLETED
5324047,1,1,1704298161,1704298163,1704298205,42,COMPLETED
5324048,1,1,1704298161,1704298163,1704298207,44,COMPLETED
5324049,1,1,1704298161,1704298163,1704298207,44,COMPLETED
5324050,1,1,1704298161,1704298163,1704298206,43,COMPLETED
5324051,1,1,1704298161,1704298163,1704298206,43,COMPLETED
5324052,1,1,1704298161,1704298163,1704298203,40,COMPLETED
5324053,1,1,1704298162,1704298163,1704298205,42,COMPLETED
5324054,1,1,1704298162,1704298163,1704298205,42,COMPLETED
5324055,1,1,1704298162,1704298163,1704298207,44,COMPLETED
5324056,1,1,1704298162,1704298163,1704298207,44,COMPLETED
5324057,1,1,1704298162,1704298163,1704298206,43,COMPLETED
5324058,1,1,1704298162,1704298163,1704298205,42,COMPLETED
5324059,1,1,1704298162,1704298163,1704298209,46,COMPLETED
5324060,1,1,1704298162,1704298163,1704298205,42,COMPLETED
5324061,1,1,1704298162,1704298163,1704298207,44,COMPLETED
5324062,1,1,1704298162,1704298163,1704298206,43,COMPLETED
5324063,1,1,1704298162,1704298163,1704298208,45,COMPLETED
5324064,1,1,1704298163,1704298163,1704298206,43,COMPLETED
5324065,1,1,1704298163,1704298163,1704298205,42,COMPLETED
5324066,1,1,1704298163,1704298163,1704298209,46,COMPLETED
5324067,1,1,1704298163,1704298163,1704298205,42,COMPLETED
5324068,1,1,1704298163,1704298163,1704298205,42,COMPLETED
5324069,1,1,1704298163,1704298167,1704298209,42,COMPLETED
5324070,1,1,1704298163,1704298167,1704298206,39,COMPLETED
5324071,1,1,1704298163,1704298167,1704298204,37,COMPLETED
5324072,1,1,1704298163,1704298167,1704298206,39,COMPLETED
5324073,1,1,1704298163,1704298167,1704298207,40,COMPLETED
5324074,1,1,1704298164,1704298167,1704298202,35,COMPLETED
5324075,1,1,1704298164,1704298167,1704298203,36,COMPLETED
5324076,1,1,1704298164,1704298167,1704298201,34,COMPLETED
5324077,1,1,1704298164,1704298167,1704298200,33,COMPLETED
5324078,1,1,1704298164,1704298167,1704298200,33,COMPLETED
5324079,1,1,1704298164,1704298167,1704298202,35,COMPLETED
5324080,1,1,1704298164,1704298167,1704298201,34,COMPLETED
5324081,1,1,1704298164,1704298167,1704298200,33,COMPLETED
5324082,1,1,1704298164,1704298167,1704298201,34,COMPLETED
5324083,1,1,1704298164,1704298167,1704298200,33,COMPLETED
5324084,1,1,1704298165,1704298167,1704298200,33,COMPLETED
5324085,1,1,1704298165,1704298167,1704298200,33,COMPLETED
5324086,1,1,1704298165,1704298167,1704298201,34,COMPLETED
5324088,1,1,1704298165,1704298167,1704298200,33,COMPLETED
5324089,1,1,1704298165,1704298167,1704298203,36,COMPLETED
5324090,1,1,1704298165,1704298167,1704298202,35,COMPLETED
5324091,1,1,1704298165,1704298167,1704298201,34,COMPLETED
5324092,1,1,1704298165,1704298167,1704298201,34,COMPLETED
5324093,1,1,1704298165,1704298167,1704298200,33,COMPLETED
5324087,1,1,1704298165,1704298167,1704298367,200,COMPLETED
5324094,1,1,1704298177,1704298177,1704298228,51,COMPLETED
5324095,1,1,1704298177,1704298177,1704298226,49,COMPLETED
5324096,1,1,1704298177,1704298177,1704298226,49,COMPLETED
5324097,1,1,1704298177,1704298177,1704298226,49,COMPLETED
5324098,1,1,1704298177,1704298177,1704298227,50,COMPLETED
5324099,1,1,1704298177,1704298177,1704298228,51,COMPLETED
5324100,1,1,1704298178,1704298178,1704298227,49,COMPLETED
5324101,1,1,1704298178,1704298178,1704298227,49,COMPLETED
5324102,1,1,1704298178,1704298178,1704298227,49,COMPLETED
5324103,1,1,1704298178,1704298178,1704298226,48,COMPLETED
5324104,1,1,1704298178,1704298178,1704298226,48,COMPLETED
5324105,1,1,1704298178,1704298178,1704298224,46,COMPLETED
5324106,1,1,1704298178,1704298178,1704298226,48,COMPLETED
5324107,1,1,1704298178,1704298178,1704298224,46,COMPLETED
5324108,1,1,1704298178,1704298178,1704298226,48,COMPLETED
5324109,1,1,1704298178,1704298178,1704298226,48,COMPLETED
5324110,1,1,1704298179,1704298179,1704298224,45,COMPLETED
5324111,1,1,1704298179,1704298179,1704298224,45,COMPLETED
5324112,1,1,1704298179,1704298179,1704298223,44,COMPLETED
5324113,1,1,1704298179,1704298179,1704298223,44,COMPLETED
5324114,1,1,1704298179,1704298179,1704298224,45,COMPLETED
5324115,1,1,1704298179,1704298179,1704298225,46,COMPLETED
5324116,1,1,1704298179,1704298179,1704298224,45,COMPLETED
5324117,1,1,1704298179,1704298179,1704298224,45,COMPLETED
5324118,1,1,1704298179,1704298179,1704298223,44,COMPLETED
5324119,1,1,1704298179,1704298179,1704298225,46,COMPLETED
5324120,1,1,1704298180,1704298180,1704298225,45,COMPLETED
5324121,1,1,1704298180,1704298180,1704298225,45,COMPLETED
5324122,1,1,1704298180,1704298180,1704298228,48,COMPLETED
5324123,1,1,1704298180,1704298180,1704298225,45,COMPLETED
5324124,1,1,1704298180,1704298180,1704298225,45,COMPLETED
5324125,1,1,1704298180,1704298180,1704298226,46,COMPLETED
5324126,1,1,1704298192,1704298192,1704298227,35,COMPLETED
5324127,1,1,1704298192,1704298192,1704298227,35,COMPLETED
5324128,1,1,1704298192,1704298192,1704298226,34,COMPLETED
5324129,1,1,1704298192,1704298192,1704298226,34,COMPLETED
5324130,1,1,1704298193,1704298196,1704298228,32,COMPLETED
5324131,1,1,1704298193,1704298196,1704298226,30,COMPLETED
5324132,1,1,1704298193,1704298196,1704298228,32,COMPLETED
5324133,1,1,1704298193,1704298196,1704298227,31,COMPLETED
5324134,1,1,1704298193,1704298196,1704298225,29,COMPLETED
5324135,1,1,1704298193,1704298196,1704298227,31,COMPLETED
5324136,1,1,1704298194,1704298196,1704298228,32,COMPLETED
5324137,1,1,1704298194,1704298196,1704298228,32,COMPLETED
5324138,1,1,1704298194,1704298196,1704298227,31,COMPLETED
5324139,1,1,1704298194,1704298196,1704298226,30,COMPLETED
5324140,1,1,1704298194,1704298196,1704298228,32,COMPLETED
5324141,1,1,1704298195,1704298196,1704298226,30,COMPLETED
5324142,1,1,1704298195,1704298196,1704298228,32,COMPLETED
5324143,1,1,1704298195,1704298196,1704298226,30,COMPLETED
5324144,1,1,1704298196,1704298196,1704298224,28,COMPLETED
5324145,1,1,1704298196,1704298196,1704298226,30,COMPLETED
5324146,1,1,1704298196,1704298196,1704298227,31,COMPLETED
5324147,1,1,1704298196,1704298196,1704298224,28,COMPLETED
5324148,1,1,1704298196,1704298196,1704298226,30,COMPLETED
5324149,1,1,1704298196,1704298196,1704298224,28,COMPLETED
5324150,1,1,1704298196,1704298196,1704298226,30,COMPLETED
5324151,1,1,1704298196,1704298196,1704298226,30,COMPLETED
5324152,1,1,1704298196,1704298196,1704298226,30,COMPLETED
5324153,1,1,1704298196,1704298196,1704298224,28,COMPLETED
5324154,1,1,1704298196,1704298196,1704298223,27,COMPLETED
5324155,1,1,1704298196,1704298196,1704298223,27,COMPLETED
5324156,1,1,1704298196,1704298198,1704298224,26,COMPLETED
5324157,1,1,1704298196,1704298198,1704298223,25,COMPLETED
5324158,1,1,1704298196,1704298198,1704298224,26,COMPLETED
5324159,1,1,1704298196,1704298198,1704298223,25,COMPLETED
5324160,1,1,1704298209,1704298209,1704298265,56,COMPLETED
5324161,1,1,1704298209,1704298210,1704298261,51,COMPLETED
5324162,1,1,1704298209,1704298210,1704298263,53,COMPLETED
5324163,1,1,1704298210,1704298211,1704298260,49,COMPLETED
5324164,1,1,1704298212,1704298214,1704298263,49,COMPLETED
5324165,1,1,1704298212,1704298214,1704298261,47,COMPLETED
5324166,1,1,1704298212,1704298214,1704298262,48,COMPLETED
5324167,1,1,1704298212,1704298214,1704298260,46,COMPLETED
5324168,1,1,1704298212,1704298214,1704298260,46,COMPLETED
5324169,1,1,1704298212,1704298214,1704298262,48,COMPLETED
5324170,1,1,1704298212,1704298214,1704298260,46,COMPLETED
5324171,1,1,1704298212,1704298214,1704298263,49,COMPLETED
5324172,1,1,1704298212,1704298214,1704298260,46,COMPLETED
5324173,1,1,1704298214,1704298218,1704298260,42,COMPLETED
5324174,1,1,1704298214,1704298218,1704298260,42,COMPLETED
5324175,1,1,1704298214,1704298218,1704298260,42,COMPLETED
5324176,1,1,1704298214,1704298218,1704298260,42,COMPLETED
5324177,1,1,1704298214,1704298218,1704298263,45,COMPLETED
5324178,1,1,1704298214,1704298218,1704298260,42,COMPLETED
5324179,1,1,1704298215,1704298218,1704298263,45,COMPLETED
5324180,1,1,1704298215,1704298218,1704298263,45,COMPLETED
5324181,1,1,1704298215,1704298218,1704298260,42,COMPLETED
5324182,1,1,1704298215,1704298218,1704298261,43,COMPLETED
5324183,1,1,1704298215,1704298218,1704298262,44,COMPLETED
5324184,1,1,1704298215,1704298218,1704298262,44,COMPLETED
5324185,1,1,1704298215,1704298218,1704298262,44,COMPLETED
5324186,1,1,1704298215,1704298218,1704298261,43,COMPLETED
5324187,1,1,1704298215,1704298218,1704298261,43,COMPLETED
5324188,1,1,1704298215,1704298218,1704298261,43,COMPLETED
5324189,1,1,1704298215,1704298218,1704298262,44,COMPLETED
5324190,1,1,1704298215,1704298218,1704298260,42,COMPLETED
5324191,1,1,1704298215,1704298218,1704298260,42,COMPLETED
5324192,1,1,1704298215,1704298218,1704298260,42,COMPLETED
5324193,1,1,1704298215,1704298218,1704298260,42,COMPLETED
5324194,1,1,1704298215,1704298218,1704298260,42,COMPLETED
5324195,1,1,1704298215,1704298218,1704298260,42,COMPLETED
5324196,1,1,1704298215,1704298218,1704298260,42,COMPLETED
5324197,1,1,1704298215,1704298218,1704298260,42,COMPLETED
5324198,1,1,1704298215,1704298218,1704298260,42,COMPLETED
5324199,1,1,1704298215,1704298218,1704298260,42,COMPLETED
5324200,1,1,1704298215,1704298218,1704298260,42,COMPLETED
5324201,1,1,1704298215,1704298218,1704298260,42,COMPLETED
5324202,1,1,1704298216,1704298218,1704298260,42,COMPLETED
5324203,1,1,1704298216,1704298218,1704298260,42,COMPLETED
5324204,1,1,1704298216,1704298218,1704298260,42,COMPLETED
5324205,1,1,1704298216,1704298218,1704298260,42,COMPLETED
5324206,1,1,1704298216,1704298218,1704298260,42,COMPLETED
5324207,1,1,1704298216,1704298218,1704298260,42,COMPLETED
5324208,1,1,1704298216,1704298218,1704298260,42,COMPLETED
5324209,1,1,1704298216,1704298218,1704298260,42,COMPLETED
5324210,1,1,1704298216,1704298218,1704298260,42,COMPLETED
5324211,1,1,1704298216,1704298218,1704298260,42,COMPLETED
5324212,1,1,1704298216,1704298218,1704298260,42,COMPLETED
5324213,1,1,1704298216,1704298218,1704298260,42,COMPLETED
5324214,1,1,1704298216,1704298218,1704298260,42,COMPLETED
5324215,1,1,1704298216,1704298218,1704298260,42,COMPLETED
5324216,1,1,1704298216,1704298218,1704298260,42,COMPLETED
5324217,1,1,1704298216,1704298218,1704298260,42,COMPLETED
5324218,1,1,1704298216,1704298218,1704298260,42,COMPLETED
5324219,1,1,1704298216,1704298218,1704298260,42,COMPLETED
5324220,1,1,1704298217,1704298218,1704298260,42,COMPLETED
5324221,1,1,1704298217,1704298218,1704298260,42,COMPLETED
5324222,1,1,1704298217,1704298218,1704298260,42,COMPLETED
5324223,1,1,1704298217,1704298218,1704298260,42,COMPLETED
5324224,1,1,1704298217,1704298218,1704298262,44,COMPLETED
5324225,1,1,1704298217,1704298218,1704298260,42,COMPLETED
5324226,1,1,1704298217,1704298218,1704298260,42,COMPLETED
5324227,1,1,1704298217,1704298218,1704298260,42,COMPLETED
5324228,1,1,1704298217,1704298218,1704298260,42,COMPLETED
5324229,1,1,1704298217,1704298218,1704298261,43,COMPLETED
5324230,1,1,1704298217,1704298218,1704298260,42,COMPLETED
5324231,1,1,1704298217,1704298218,1704298261,43,COMPLETED
5324232,1,1,1704298217,1704298218,1704298260,42,COMPLETED
5324233,1,1,1704298217,1704298218,1704298260,42,COMPLETED
5324234,1,1,1704298218,1704298222,1704298261,39,COMPLETED
5324235,1,1,1704298218,1704298222,1704298260,38,COMPLETED
5324236,1,1,1704298218,1704298222,1704298260,38,COMPLETED
5324237,1,1,1704298218,1704298222,1704298260,38,COMPLETED
5324238,1,1,1704298218,1704298222,1704298260,38,COMPLETED
5324239,1,1,1704298218,1704298222,1704298260,38,COMPLETED
5324240,1,1,1704298218,1704298222,1704298260,38,COMPLETED
5324241,1,1,1704298218,1704298222,1704298260,38,COMPLETED
5324242,1,1,1704298218,1704298222,1704298260,38,COMPLETED
5324243,1,1,1704298218,1704298222,1704298260,38,COMPLETED
5324244,1,1,1704298219,1704298222,1704298260,38,COMPLETED
5324245,1,1,1704298219,1704298222,1704298260,38,COMPLETED
5324246,1,1,1704298219,1704298222,1704298260,38,COMPLETED
5324247,1,1,1704298219,1704298222,1704298260,38,COMPLETED
5324248,1,1,1704298219,1704298222,1704298260,38,COMPLETED
5324249,1,1,1704298219,1704298222,1704298260,38,COMPLETED
5324250,1,1,1704298219,1704298222,1704298260,38,COMPLETED
5324251,1,1,1704298219,1704298222,1704298260,38,COMPLETED
5324252,1,1,1704298219,1704298222,1704298260,38,COMPLETED
5324253,1,1,1704298220,1704298222,1704298260,38,COMPLETED
5324254,1,1,1704298220,1704298222,1704298260,38,COMPLETED
5324255,1,1,1704298220,1704298222,1704298260,38,COMPLETED
5324256,1,1,1704298220,1704298222,1704298260,38,COMPLETED
5324257,1,1,1704298220,1704298222,1704298260,38,COMPLETED
5324258,1,1,1704298220,1704298222,1704298260,38,COMPLETED
5324259,1,1,1704298220,1704298222,1704298260,38,COMPLETED
5324260,1,1,1704298220,1704298222,1704298260,38,COMPLETED
5324261,1,1,1704298220,1704298222,1704298260,38,COMPLETED
5324262,1,1,1704298220,1704298222,1704298260,38,COMPLETED
5324263,1,1,1704298220,1704298222,1704298260,38,COMPLETED
5324264,1,1,1704298221,1704298222,1704298260,38,COMPLETED
5324265,1,1,1704298221,1704298222,1704298260,38,COMPLETED
5324266,1,1,1704298221,1704298222,1704298260,38,COMPLETED
5324267,1,1,1704298221,1704298222,1704298260,38,COMPLETED
5324268,1,1,1704298221,1704298222,1704298261,39,COMPLETED
5324269,1,1,1704298223,1704298224,1704298260,36,COMPLETED
5324270,1,1,1704298223,1704298224,1704298260,36,COMPLETED
5324271,1,1,1704298223,1704298224,1704298260,36,COMPLETED
5324272,1,1,1704298223,1704298224,1704298260,36,COMPLETED
5324273,1,1,1704298223,1704298224,1704298262,38,COMPLETED
5324274,1,1,1704298223,1704298224,1704298261,37,COMPLETED
5324275,1,1,1704298223,1704298224,1704298262,38,COMPLETED
5324276,1,1,1704298223,1704298224,1704298265,41,COMPLETED
5324277,1,1,1704298223,1704298224,1704298262,38,COMPLETED
5324278,1,1,1704298223,1704298224,1704298261,37,COMPLETED
5324279,1,1,1704298223,1704298224,1704298260,36,COMPLETED
5324280,1,1,1704298223,1704298224,1704298261,37,COMPLETED
5324281,1,1,1704298223,1704298224,1704298260,36,COMPLETED
5324282,1,1,1704298223,1704298224,1704298261,37,COMPLETED
5324283,1,1,1704298224,1704298224,1704298261,37,COMPLETED
5324284,1,1,1704298224,1704298224,1704298262,38,COMPLETED
5324285,1,1,1704298224,1704298224,1704298260,36,COMPLETED
5324286,1,1,1704298224,1704298224,1704298260,36,COMPLETED
5324287,1,1,1704298224,1704298224,1704298262,38,COMPLETED
5324288,1,1,1704298224,1704298224,1704298260,36,COMPLETED
5324289,1,1,1704298224,1704298224,1704298262,38,COMPLETED
5324290,1,1,1704298224,1704298224,1704298260,36,COMPLETED
5324291,1,1,1704298224,1704298224,1704298260,36,COMPLETED
5324292,1,1,1704298224,1704298224,1704298260,36,COMPLETED
5324293,1,1,1704298224,1704298224,1704298260,36,COMPLETED
5324294,1,1,1704298225,1704298225,1704298260,35,COMPLETED
5324295,1,1,1704298225,1704298225,1704298260,35,COMPLETED
5324296,1,1,1704298225,1704298225,1704298262,37,COMPLETED
5324297,1,1,1704298225,1704298225,1704298262,37,COMPLETED
5324298,1,1,1704298225,1704298225,1704298264,39,COMPLETED
5324299,1,1,1704298225,1704298225,1704298260,35,COMPLETED
5324300,1,1,1704298225,1704298225,1704298261,36,COMPLETED
5324301,1,1,1704298248,1704298258,1704298288,30,COMPLETED
5324302,1,1,1704298248,1704298258,1704298288,30,COMPLETED
5324303,1,1,1704298248,1704298258,1704298288,30,COMPLETED
5324304,1,1,1704298248,1704298258,1704298288,30,COMPLETED
5324305,1,1,1704298248,1704298258,1704298288,30,COMPLETED
5324306,1,1,1704298249,1704298258,1704298288,30,COMPLETED
5324307,1,1,1704298249,1704298258,1704298288,30,COMPLETED
5324308,1,1,1704298249,1704298258,1704298288,30,COMPLETED
5324309,1,1,1704298249,1704298258,1704298288,30,COMPLETED
5324310,1,1,1704298249,1704298258,1704298289,31,COMPLETED
5324311,1,1,1704298249,1704298258,1704298288,30,COMPLETED
5324312,1,1,1704298250,1704298258,1704298288,30,COMPLETED
5324313,1,1,1704298250,1704298258,1704298288,30,COMPLETED
5324314,1,1,1704298250,1704298258,1704298288,30,COMPLETED
5324315,1,1,1704298250,1704298258,1704298288,30,COMPLETED
5324316,1,1,1704298250,1704298258,1704298288,30,COMPLETED
5324317,1,1,1704298250,1704298258,1704298288,30,COMPLETED
5324318,1,1,1704298250,1704298258,1704298288,30,COMPLETED
5324319,1,1,1704298250,1704298258,1704298287,29,COMPLETED
5324320,1,1,1704298250,1704298258,1704298288,30,COMPLETED
5324321,1,1,1704298250,1704298258,1704298287,29,COMPLETED
5324322,1,1,1704298250,1704298258,1704298288,30,COMPLETED
5324323,1,1,1704298251,1704298258,1704298288,30,COMPLETED
5324324,1,1,1704298251,1704298258,1704298288,30,COMPLETED
5324325,1,1,1704298251,1704298258,1704298288,30,COMPLETED
5324326,1,1,1704298251,1704298258,1704298288,30,COMPLETED
5324327,1,1,1704298251,1704298258,1704298288,30,COMPLETED
5324328,1,1,1704298251,1704298258,1704298288,30,COMPLETED
5324329,1,1,1704298251,1704298258,1704298288,30,COMPLETED
5324330,1,1,1704298251,1704298258,1704298288,30,COMPLETED
5324331,1,1,1704298251,1704298258,1704298288,30,COMPLETED
5324332,36,1,1704298363,1704298363,1704299194,831,CANCELLED by 8510
5324333,1,1,1704298409,1704298409,1704298690,281,COMPLETED
5324334,1,1,1704298409,1704298409,1704298696,287,COMPLETED
5324335,1,1,1704298409,1704298409,1704298699,290,COMPLETED
5324336,1,1,1704298409,1704298413,1704298717,304,COMPLETED
5324337,1,1,1704298409,1704298413,1704298692,279,COMPLETED
5324338,1,1,1704298409,1704298413,1704298720,307,COMPLETED
5324339,1,1,1704298409,1704298413,1704298699,286,COMPLETED
5324340,1,1,1704298409,1704298413,1704298708,295,COMPLETED
5324341,1,1,1704298409,1704298413,1704298690,277,COMPLETED
5324342,1,1,1704298409,1704298413,1704298715,302,COMPLETED
5324343,1,1,1704298409,1704298413,1704298701,288,COMPLETED
5324344,1,1,1704298409,1704298413,1704298699,286,COMPLETED
5324345,1,1,1704298409,1704298413,1704298696,283,COMPLETED
5324346,1,1,1704298409,1704298413,1704298704,291,COMPLETED
5324347,1,1,1704298409,1704298413,1704298692,279,COMPLETED
5324348,1,1,1704298409,1704298413,1704298712,299,COMPLETED
5324349,1,1,1704298409,1704298413,1704298713,300,COMPLETED
5324350,1,1,1704298409,1704298413,1704298717,304,COMPLETED
5324351,1,1,1704298409,1704298413,1704298680,267,COMPLETED
5324352,1,1,1704298409,1704298413,1704298690,277,COMPLETED
5324353,1,1,1704298409,1704298413,1704298704,291,COMPLETED
5324354,1,1,1704298409,1704298413,1704298704,291,COMPLETED
5324355,1,1,1704298409,1704298413,1704298704,291,COMPLETED
5324356,1,1,1704298409,1704298413,1704298708,295,COMPLETED
5324357,1,1,1704298409,1704298413,1704298678,265,COMPLETED
5324358,1,1,1704298409,1704298413,1704298699,286,COMPLETED
5324359,1,1,1704298409,1704298413,1704298715,302,COMPLETED
5324360,1,1,1704298409,1704298413,1704298708,295,COMPLETED
5324361,1,1,1704298409,1704298413,1704298711,298,COMPLETED
5324362,1,1,1704298409,1704298413,1704298719,306,COMPLETED
5324363,1,1,1704298409,1704298413,1704298719,306,COMPLETED
5324364,1,1,1704298409,1704298413,1704298705,292,COMPLETED
5324365,1,1,1704298409,1704298413,1704298668,255,COMPLETED
5324366,1,1,1704298409,1704298413,1704298713,300,COMPLETED
5324367,1,1,1704298409,1704298413,1704298715,302,COMPLETED
5324368,1,1,1704298410,1704298413,1704298720,307,COMPLETED
5324369,1,1,1704298410,1704298413,1704298690,277,COMPLETED
5324370,1,1,1704298410,1704298413,1704298710,297,COMPLETED
5324371,1,1,1704298410,1704298413,1704298678,265,COMPLETED
5324372,1,1,1704298410,1704298413,1704298724,311,COMPLETED
5324373,1,1,1704298410,1704298413,1704298718,305,COMPLETED
5324374,1,1,1704298410,1704298413,1704298714,301,COMPLETED
5324375,1,1,1704298410,1704298413,1704298722,309,COMPLETED
5324376,1,1,1704298410,1704298413,1704298726,313,COMPLETED
5324377,1,1,1704298410,1704298413,1704298704,291,COMPLETED
5324378,1,1,1704298410,1704298413,1704298708,295,COMPLETED
5324379,1,1,1704298410,1704298413,1704298709,296,COMPLETED
5324380,1,1,1704298410,1704298413,1704298726,313,COMPLETED
5324381,1,1,1704298410,1704298413,1704298727,314,COMPLETED
5324382,1,1,1704298410,1704298413,1704298696,283,COMPLETED
5324383,1,1,1704298410,1704298413,1704298678,265,COMPLETED
5324384,1,1,1704298410,1704298413,1704298702,289,COMPLETED
5324385,1,1,1704298410,1704298413,1704298681,268,COMPLETED
5324386,1,1,1704298410,1704298413,1704298696,283,COMPLETED
5324387,1,1,1704298410,1704298413,1704298722,309,COMPLETED
5324388,1,1,1704298410,1704298413,1704298723,310,COMPLETED
5324389,1,1,1704298410,1704298413,1704298715,302,COMPLETED
5324390,1,1,1704298410,1704298413,1704298718,305,COMPLETED
5324391,1,1,1704298410,1704298413,1704298722,309,COMPLETED
5324392,1,1,1704298410,1704298413,1704298719,306,COMPLETED
5324393,1,1,1704298410,1704298413,1704298726,313,COMPLETED
5324394,1,1,1704298410,1704298413,1704298681,268,COMPLETED
5324395,1,1,1704298410,1704298413,1704298701,288,COMPLETED
5324396,1,1,1704298410,1704298413,1704298704,291,COMPLETED
5324397,1,1,1704298410,1704298413,1704298712,299,COMPLETED
5324398,1,1,1704298410,1704298413,1704298690,277,COMPLETED
5324399,1,1,1704298410,1704298413,1704298704,291,COMPLETED
5324400,1,1,1704298410,1704298413,1704298711,298,COMPLETED
5324401,1,1,1704298410,1704298413,1704298718,305,COMPLETED
5324402,1,1,1704298411,1704298413,1704298696,283,COMPLETED
5324403,1,1,1704298411,1704298413,1704298719,306,COMPLETED
5324404,1,1,1704298411,1704298413,1704298722,309,COMPLETED
5324405,1,1,1704298411,1704298413,1704298655,242,COMPLETED
5324406,1,1,1704298411,1704298413,1704298655,242,COMPLETED
5324407,1,1,1704298411,1704298413,1704298629,216,COMPLETED
5324408,1,1,1704298411,1704298413,1704298646,233,COMPLETED
5324409,1,1,1704298411,1704298413,1704298629,216,COMPLETED
5324410,1,1,1704298411,1704298413,1704298637,224,COMPLETED
5324411,1,1,1704298411,1704298413,1704298681,268,COMPLETED
5324412,1,1,1704298411,1704298413,1704298647,234,COMPLETED
5324413,1,1,1704298411,1704298413,1704298668,255,COMPLETED
5324414,1,1,1704298411,1704298413,1704298637,224,COMPLETED
5324415,1,1,1704298411,1704298413,1704298655,242,COMPLETED
5324416,1,1,1704298411,1704298413,1704298647,234,COMPLETED
5324417,1,1,1704298411,1704298413,1704298646,233,COMPLETED
5324418,1,1,1704298411,1704298413,1704298629,216,COMPLETED
5324419,1,1,1704298411,1704298413,1704298655,242,COMPLETED
5324420,1,1,1704298411,1704298413,1704298646,233,COMPLETED
5324421,1,1,1704298411,1704298413,1704298638,225,COMPLETED
5324422,1,1,1704298411,1704298413,1704298646,233,COMPLETED
5324423,1,1,1704298411,1704298413,1704298637,224,COMPLETED
5324424,1,1,1704298411,1704298413,1704298655,242,COMPLETED
5324425,1,1,1704298411,1704298413,1704298637,224,COMPLETED
5324426,1,1,1704298411,1704298413,1704298646,233,COMPLETED
5324433,1,1,1704298749,1704298749,1704299012,263,COMPLETED
5324434,1,1,1704298749,1704298749,1704298998,249,COMPLETED
5324435,1,1,1704298749,1704298749,1704298987,238,COMPLETED
5324436,1,1,1704298749,1704298749,1704299007,258,COMPLETED
5324437,1,1,1704298749,1704298749,1704299013,264,COMPLETED
5324438,1,1,1704298749,1704298749,1704298999,250,COMPLETED
5324439,1,1,1704298749,1704298749,1704299015,266,COMPLETED
5324440,1,1,1704298749,1704298749,1704299010,261,COMPLETED
5324441,1,1,1704298749,1704298749,1704299041,292,COMPLETED
5324442,1,1,1704298749,1704298749,1704299009,260,COMPLETED
5324443,1,1,1704298749,1704298749,1704299007,258,COMPLETED
5324444,1,1,1704298749,1704298749,1704298999,250,COMPLETED
5324445,1,1,1704298749,1704298749,1704299006,257,COMPLETED
5324446,1,1,1704298749,1704298749,1704298995,246,COMPLETED
5324447,1,1,1704298749,1704298749,1704298993,244,COMPLETED
5324448,1,1,1704298749,1704298749,1704298974,225,COMPLETED
5324449,1,1,1704298749,1704298749,1704299009,260,COMPLETED
5324450,1,1,1704298749,1704298749,1704298998,249,COMPLETED
5324451,1,1,1704298749,1704298749,1704298987,238,COMPLETED
5324452,1,1,1704298749,1704298749,1704298985,236,COMPLETED
5324453,1,1,1704298749,1704298749,1704298993,244,COMPLETED
5324454,1,1,1704298749,1704298749,1704299001,252,COMPLETED
5324455,1,1,1704298749,1704298749,1704299018,269,COMPLETED
5324456,1,1,1704298749,1704298749,1704298986,237,COMPLETED
5324457,1,1,1704298749,1704298749,1704298995,246,COMPLETED
5324458,1,1,1704298749,1704298749,1704299004,255,COMPLETED
5324459,1,1,1704298749,1704298749,1704298999,250,COMPLETED
5324460,1,1,1704298749,1704298749,1704299015,266,COMPLETED
5324461,1,1,1704298749,1704298749,1704299006,257,COMPLETED
5324462,1,1,1704298749,1704298749,1704298968,219,COMPLETED
5324463,1,1,1704298749,1704298749,1704299007,258,COMPLETED
5324464,1,1,1704298749,1704298749,1704298990,241,COMPLETED
5324465,1,1,1704298749,1704298749,1704298994,245,COMPLETED
5324466,1,1,1704298749,1704298749,1704299012,263,COMPLETED
5324467,1,1,1704298749,1704298749,1704299016,267,COMPLETED
5324468,1,1,1704298749,1704298749,1704298990,241,COMPLETED
5324469,1,1,1704298749,1704298749,1704299017,268,COMPLETED
5324470,1,1,1704298749,1704298749,1704298988,239,COMPLETED
5324471,1,1,1704298749,1704298749,1704299006,257,COMPLETED
5324472,1,1,1704298749,1704298749,1704299001,252,COMPLETED
5324473,1,1,1704298749,1704298749,1704299005,256,COMPLETED
5324474,1,1,1704298749,1704298749,1704299010,261,COMPLETED
5324475,1,1,1704298749,1704298749,1704299001,252,COMPLETED
5324476,1,1,1704298749,1704298749,1704299005,256,COMPLETED
5324477,1,1,1704298749,1704298749,1704299014,265,COMPLETED
5324478,1,1,1704298749,1704298749,1704298992,243,COMPLETED
5324479,1,1,1704298749,1704298749,1704298998,249,COMPLETED
5324480,1,1,1704298749,1704298749,1704299001,252,COMPLETED
5324481,1,1,1704298749,1704298749,1704299002,253,COMPLETED
5324482,1,1,1704298749,1704298749,1704299011,262,COMPLETED
5324483,1,1,1704298749,1704298749,1704299011,262,COMPLETED
5324484,1,1,1704298749,1704298749,1704298991,242,COMPLETED
5324485,1,1,1704298749,1704298749,1704298999,250,COMPLETED
5324486,1,1,1704298749,1704298749,1704299001,252,COMPLETED
5324487,1,1,1704298749,1704298749,1704298985,236,COMPLETED
5324488,1,1,1704298749,1704298749,1704299014,265,COMPLETED
5324489,1,1,1704298749,1704298749,1704299015,266,COMPLETED
5324490,1,1,1704298749,1704298751,1704299003,252,COMPLETED
5324491,1,1,1704298750,1704298751,1704299019,268,COMPLETED
5324492,1,1,1704298750,1704298751,1704299007,256,COMPLETED
5324493,1,1,1704298750,1704298751,1704299003,252,COMPLETED
5324494,1,1,1704298750,1704298751,1704299002,251,COMPLETED
5324495,1,1,1704298750,1704298751,1704299015,264,COMPLETED
5324496,1,1,1704298750,1704298751,1704298995,244,COMPLETED
5324497,1,1,1704298750,1704298751,1704299010,259,COMPLETED
5324498,1,1,1704298750,1704298751,1704299003,252,COMPLETED
5324499,1,1,1704298750,1704298751,1704299014,263,COMPLETED
5324500,1,1,1704298750,1704298751,1704298976,225,COMPLETED
5324501,1,1,1704298750,1704298751,1704299005,254,COMPLETED
5324502,1,1,1704298750,1704298751,1704298992,241,COMPLETED
5324503,1,1,1704298750,1704298751,1704299009,258,COMPLETED
5324504,1,1,1704298750,1704298751,1704299018,267,COMPLETED
5324505,1,1,1704298750,1704298751,1704298998,247,COMPLETED
5324506,1,1,1704298750,1704298751,1704298983,232,COMPLETED
5324507,1,1,1704298750,1704298751,1704298983,232,COMPLETED
5324508,1,1,1704298750,1704298751,1704298972,221,COMPLETED
5324509,1,1,1704298750,1704298751,1704298975,224,COMPLETED
5324510,1,1,1704298750,1704298751,1704298978,227,COMPLETED
5324511,1,1,1704298750,1704298751,1704298993,242,COMPLETED
5324512,1,1,1704298750,1704298751,1704298987,236,COMPLETED
5324513,1,1,1704298750,1704298751,1704298957,206,COMPLETED
5324514,1,1,1704298750,1704298751,1704298998,247,COMPLETED
5324515,1,1,1704298750,1704298751,1704298972,221,COMPLETED
5324516,1,1,1704298750,1704298751,1704298957,206,COMPLETED
5324517,1,1,1704298750,1704298751,1704298983,232,COMPLETED
5324518,1,1,1704298750,1704298751,1704298985,234,COMPLETED
5324519,1,1,1704298750,1704298751,1704298968,217,COMPLETED
5324520,1,1,1704298751,1704298751,1704298988,237,COMPLETED
5324521,1,1,1704298751,1704298751,1704298986,235,COMPLETED
5324522,1,1,1704298751,1704298751,1704298995,244,COMPLETED
5324523,1,1,1704298751,1704298751,1704298993,242,COMPLETED
5324525,1,1,1704298751,1704298751,1704298976,225,COMPLETED
5324526,1,1,1704298751,1704298751,1704298964,213,COMPLETED
5324527,1,1,1704298751,1704298751,1704298983,232,COMPLETED
5324528,1,1,1704298751,1704298751,1704298990,239,COMPLETED
5324529,1,1,1704298751,1704298751,1704298998,247,COMPLETED
5324530,1,1,1704298751,1704298751,1704298947,196,COMPLETED
5324531,1,1,1704298751,1704298751,1704298985,234,COMPLETED
5324532,1,1,1704298751,1704298751,1704298988,237,COMPLETED
5324533,1,1,1704298751,1704298751,1704298995,244,COMPLETED
5324534,1,1,1704298751,1704298751,1704298975,224,COMPLETED
5324535,432,12,1704298801,1704320478,1704451461,130983,COMPLETED
5324550,36,1,1704299231,1704299231,1704342435,43204,TIMEOUT
5324551,1,1,1704303014,1704303014,1704303019,5,COMPLETED
5324552,1,1,1704303034,1704303035,1704303036,1,COMPLETED
5324553,1,1,1704303034,1704303035,1704303036,1,COMPLETED
5324554,1,1,1704303034,1704303035,1704303042,7,COMPLETED
5324555,1,1,1704303034,1704303035,1704303038,3,COMPLETED
5324556,1,1,1704303034,1704303035,1704303042,7,COMPLETED
5324557,288,8,1704303305,1704333130,1704376343,43213,TIMEOUT
5324558,288,8,1704303305,1704422201,1704465428,43227,TIMEOUT
5324559,288,8,1704303305,1704470776,1704514004,43228,TIMEOUT
5324560,288,8,1704303305,1704514015,1704557239,43224,TIMEOUT
5324561,288,8,1704303305,1704557249,1704600472,43223,TIMEOUT
5324562,288,8,1704303305,1704600483,1704643704,43221,TIMEOUT
5324563,36,1,1704305211,1704305212,1704305218,6,COMPLETED
5324564,36,1,1704306473,1704306473,1704307103,630,CANCELLED by 46924
5324565,36,1,1704307339,1704307339,1704308099,760,CANCELLED by 46924
5324566,36,1,1704308253,1704308253,1704311557,3304,COMPLETED
5324568,36,1,1704311785,1704311787,1704311800,13,FAILED
5324569,36,1,1704312493,1704312493,1704312509,16,FAILED
5324570,36,1,1704314163,1704314163,1704314171,8,FAILED
5324571,36,1,1704314547,1704314548,1704315087,539,CANCELLED by 46924
5324572,18,1,1704314709,1704314709,1704314719,10,COMPLETED
5324573,1,1,1704315004,1704315005,1704315007,2,COMPLETED
5324574,1,1,1704315004,1704315005,1704315009,4,COMPLETED
5324575,1,1,1704315005,1704315005,1704315012,7,COMPLETED
5324576,1,1,1704315005,1704315005,1704315007,2,COMPLETED
5324577,1,1,1704315005,1704315008,1704315012,4,COMPLETED
5324578,1,1,1704315069,1704315069,1704315070,1,COMPLETED
5324579,1,1,1704315069,1704315072,1704315073,1,COMPLETED
5324583,1,1,1704315069,1704315072,1704315073,1,COMPLETED
5324584,1,1,1704315069,1704315072,1704315073,1,COMPLETED
5324580,2,1,1704315069,1704315072,1704315083,11,COMPLETED
5324581,2,1,1704315069,1704315072,1704315083,11,COMPLETED
5324582,2,1,1704315069,1704315072,1704315083,11,COMPLETED
5324585,1,1,1704315070,1704315072,1704315073,1,COMPLETED
5324586,1,1,1704315070,1704315072,1704315073,1,COMPLETED
5324590,1,1,1704315071,1704315072,1704315077,5,COMPLETED
5324588,2,1,1704315071,1704315072,1704315083,11,COMPLETED
5324589,2,1,1704315071,1704315072,1704315083,11,COMPLETED
5324587,2,1,1704315071,1704315072,1704315191,119,COMPLETED
5324592,1,1,1704315072,1704315072,1704315073,1,COMPLETED
5324594,1,1,1704315072,1704315072,1704315073,1,COMPLETED
5324596,1,1,1704315072,1704315073,1704315076,3,COMPLETED
5324591,2,1,1704315072,1704315072,1704315083,11,COMPLETED
5324595,2,1,1704315072,1704315073,1704315083,10,COMPLETED
5324597,2,1,1704315072,1704315073,1704315083,10,COMPLETED
5324593,2,1,1704315072,1704315072,1704315190,118,COMPLETED
5324598,1,1,1704315073,1704315073,1704315074,1,COMPLETED
5324599,1,1,1704315073,1704315073,1704315074,1,COMPLETED
5324600,2,1,1704315073,1704315074,1704315083,9,COMPLETED
5324602,2,1,1704315073,1704315074,1704315083,9,COMPLETED
5324603,1,1,1704315073,1704315074,1704315076,2,COMPLETED
5324601,2,1,1704315073,1704315074,1704315194,120,COMPLETED
5324604,2,1,1704315074,1704315074,1704315083,9,COMPLETED
5324606,1,1,1704315074,1704315074,1704315075,1,COMPLETED
5324607,1,1,1704315074,1704315074,1704315076,2,COMPLETED
5324608,1,1,1704315074,1704315074,1704315076,2,COMPLETED
5324609,1,1,1704315074,1704315074,1704315077,3,COMPLETED
5324610,1,1,1704315074,1704315074,1704315076,2,COMPLETED
5324612,2,1,1704315074,1704315074,1704315083,9,COMPLETED
5324605,2,1,1704315074,1704315074,1704315172,98,COMPLETED
5324611,2,1,1704315074,1704315074,1704315193,119,COMPLETED
5324613,1,1,1704315075,1704315075,1704315076,1,COMPLETED
5324614,1,1,1704315075,1704315075,1704315076,1,COMPLETED
5324615,1,1,1704315075,1704315075,1704315077,2,COMPLETED
5324616,1,1,1704315075,1704315075,1704315076,1,COMPLETED
5324617,2,1,1704315075,1704315077,1704315083,6,COMPLETED
5324618,1,1,1704315075,1704315077,1704315078,1,COMPLETED
5324619,1,1,1704315076,1704315077,1704315078,1,COMPLETED
5324620,1,1,1704315076,1704315077,1704315079,2,COMPLETED
5324621,1,1,1704315076,1704315077,1704315078,1,COMPLETED
5324622,2,1,1704315076,1704315077,1704315083,6,COMPLETED
5324623,1,1,1704315076,1704315077,1704315078,1,COMPLETED
5324624,1,1,1704315077,1704315077,1704315078,1,COMPLETED
5324625,2,1,1704315077,1704315077,1704315083,6,COMPLETED
5324626,1,1,1704315077,1704315078,1704315079,1,COMPLETED
5324627,1,1,1704315077,1704315078,1704315079,1,COMPLETED
5324628,1,1,1704315077,1704315078,1704315079,1,COMPLETED
5324629,1,1,1704315077,1704315078,1704315079,1,COMPLETED
5324630,2,1,1704315078,1704315078,1704315083,5,COMPLETED
5324631,1,1,1704315078,1704315078,1704315079,1,COMPLETED
5324632,1,1,1704315078,1704315078,1704315079,1,COMPLETED
5324633,1,1,1704315078,1704315078,1704315079,1,COMPLETED
5324634,1,1,1704315078,1704315078,1704315081,3,COMPLETED
5324635,2,1,1704315078,1704315079,1704315083,4,COMPLETED
5324636,2,1,1704315079,1704315079,1704315084,5,COMPLETED
5324638,1,1,1704315079,1704315079,1704315080,1,COMPLETED
5324639,2,1,1704315079,1704315079,1704315084,5,COMPLETED
5324640,1,1,1704315079,1704315079,1704315080,1,COMPLETED
5324641,1,1,1704315079,1704315079,1704315080,1,COMPLETED
5324642,1,1,1704315079,1704315080,1704315081,1,COMPLETED
5324643,2,1,1704315079,1704315080,1704315084,4,COMPLETED
5324637,2,1,1704315079,1704315079,1704315289,210,COMPLETED
5324646,1,1,1704315080,1704315080,1704315081,1,COMPLETED
5324647,1,1,1704315080,1704315080,1704315082,2,COMPLETED
5324648,2,1,1704315080,1704315080,1704315084,4,COMPLETED
5324649,2,1,1704315080,1704315081,1704315085,4,COMPLETED
5324650,2,1,1704315080,1704315081,1704315085,4,COMPLETED
5324651,1,1,1704315080,1704315081,1704315083,2,COMPLETED
5324652,2,1,1704315080,1704315081,1704315085,4,COMPLETED
5324644,2,1,1704315080,1704315080,1704315172,92,COMPLETED
5324645,2,1,1704315080,1704315080,1704315153,73,COMPLETED
5324653,2,1,1704315081,1704315081,1704315085,4,COMPLETED
5324654,1,1,1704315081,1704315081,1704315083,2,COMPLETED
5324655,1,1,1704315081,1704315081,1704315083,2,COMPLETED
5324656,1,1,1704315081,1704315081,1704315083,2,COMPLETED
5324657,2,1,1704315081,1704315081,1704315085,4,COMPLETED
5324661,2,1,1704315081,1704315081,1704315085,4,COMPLETED
5324658,2,1,1704315081,1704315081,1704315147,66,COMPLETED
5324659,2,1,1704315081,1704315081,1704315171,90,COMPLETED
5324660,2,1,1704315081,1704315081,1704315171,90,COMPLETED
5324662,2,1,1704315081,1704315082,1704315146,64,COMPLETED
5324663,2,1,1704315082,1704315082,1704315086,4,COMPLETED
5324664,2,1,1704315082,1704315082,1704315087,5,COMPLETED
5324665,2,1,1704315082,1704315082,1704315087,5,COMPLETED
5324666,2,1,1704315082,1704315082,1704315087,5,COMPLETED
5324667,2,1,1704315082,1704315082,1704315087,5,COMPLETED
5324668,2,1,1704315082,1704315083,1704315172,89,COMPLETED
5324670,1,1,1704315083,1704315083,1704315084,1,COMPLETED
5324671,1,1,1704315083,1704315083,1704315085,2,COMPLETED
5324672,1,1,1704315083,1704315083,1704315085,2,COMPLETED
5324673,1,1,1704315083,1704315083,1704315085,2,COMPLETED
5324674,1,1,1704315083,1704315083,1704315085,2,COMPLETED
5324677,2,1,1704315083,1704315083,1704315089,6,COMPLETED
5324678,2,1,1704315083,1704315084,1704315088,4,COMPLETED
5324669,2,1,1704315083,1704315083,1704315171,88,COMPLETED
5324675,2,1,1704315083,1704315083,1704315149,66,COMPLETED
5324676,2,1,1704315083,1704315083,1704315176,93,COMPLETED
5324679,2,1,1704315084,1704315084,1704315177,93,COMPLETED
5324680,36,1,1704315124,1704315124,1704315844,720,COMPLETED
5324681,1,1,1704315618,1704315619,1704315623,4,COMPLETED
5324683,1,1,1704315618,1704315640,1704315642,2,COMPLETED
5324685,1,1,1704315709,1704315710,1704315713,3,COMPLETED
5324687,1,1,1704315709,1704315725,1704315728,3,COMPLETED
5324689,36,1,1704315722,1704315722,1704315774,52,COMPLETED
5324690,36,1,1704316189,1704316189,1704316214,25,COMPLETED
5324691,36,1,1704316381,1704316382,1704316448,66,COMPLETED
5324695,22,1,1704318588,None,1704318886,0,CANCELLED by 46077
5324696,22,1,1704318908,1704333130,1704503197,170067,CANCELLED by 46077
5324697,36,1,1704319974,1704319975,1704320475,500,COMPLETED
5324698,36,1,1704320234,1704320234,1704320307,73,CANCELLED by 7504
5324699,36,1,1704320238,1704320239,1704320305,66,CANCELLED by 7504
5324700,36,1,1704320338,1704320339,1704320477,138,FAILED
5324701,22,1,1704320693,1704333131,1704333135,4,COMPLETED
5324702,108,3,1704321138,1704333136,1704503122,169986,CANCELLED by 46077
5324703,24,1,1704321773,1704335900,1704508720,172820,TIMEOUT
5324704,24,1,1704321990,1704336788,1704509590,172802,TIMEOUT
5324713,36,1,1704345703,1704345703,1704345704,1,COMPLETED
5324714,36,1,1704348574,1704348575,1704348577,2,FAILED
5324715,36,1,1704348888,1704348888,1704349091,203,COMPLETED
5324720,36,1,1704358618,1704358618,1704358620,2,COMPLETED
5324721,36,1,1704358667,1704358667,1704358668,1,COMPLETED
5324723,72,1,1704359287,1704359287,1704359287,0,FAILED
5324724,144,2,1704359371,1704359371,1704359371,0,FAILED
5324725,72,2,1704359425,1704359426,1704361274,1848,COMPLETED
5324728_1,36,1,1704362249,1704362251,1704362254,3,FAILED
5324728_2,36,1,1704362249,1704362251,1704362254,3,FAILED
5324728_3,36,1,1704362249,1704362251,1704362254,3,FAILED
5324731_1,36,1,1704362308,1704362311,1704454934,92623,COMPLETED
5324731_2,36,1,1704362308,1704362311,1704376667,14356,COMPLETED
5324731_3,36,1,1704362308,1704362311,1704376182,13871,COMPLETED
5324734_1,36,1,1704362413,1704362414,1704452851,90437,COMPLETED
5324734_2,36,1,1704362413,1704362414,1704453359,90945,COMPLETED
5324734_3,36,1,1704362413,1704362414,1704438400,75986,COMPLETED
5324737_1,36,1,1704362445,1704362445,1704451421,88976,COMPLETED
5324737_2,36,1,1704362445,1704362445,1704432521,70076,COMPLETED
5324737_3,36,1,1704362445,1704362445,1704460643,98198,COMPLETED
5324740_1,36,1,1704362521,1704362521,1704441196,78675,COMPLETED
5324740_2,36,1,1704362521,1704362521,1704454579,92058,COMPLETED
5324740_3,36,1,1704362521,1704362521,1704365511,2990,COMPLETED
5324743_1,36,1,1704364134,1704364135,1704457504,93369,COMPLETED
5324743_2,36,1,1704364134,1704364135,1704443949,79814,COMPLETED
5324743_3,36,1,1704364134,1704364135,1704428491,64356,COMPLETED
5324746,144,4,1704364205,1704364205,1704449669,85464,COMPLETED
5324747,144,4,1704364205,1704364205,1704450163,85958,COMPLETED
5324748,144,4,1704364205,1704364722,1704449943,85221,COMPLETED
5324749,216,6,1704364205,1704378543,1704435496,56953,COMPLETED
5324750,216,6,1704364205,1704390657,1704447458,56801,COMPLETED
5324751,144,4,1704364205,1704391274,1704476666,85392,COMPLETED
5324752,216,6,1704364220,1704391797,1704461045,69248,COMPLETED
5324753,216,6,1704364220,1704391889,1704461076,69187,COMPLETED
5324754,216,6,1704364220,1704394171,1704463554,69383,COMPLETED
5324755,144,4,1704364220,1704461141,1704546533,85392,COMPLETED
5324756,216,6,1704364221,1704396998,1704455486,58488,COMPLETED
5324757,144,4,1704364221,1704465825,1704551233,85408,COMPLETED
5324758,216,6,1704364221,1704396998,1704462243,65245,COMPLETED
5324759,216,6,1704364221,1704398083,1704462961,64878,COMPLETED
5324760,216,6,1704364221,1704400387,1704465160,64773,COMPLETED
5324761_1,36,1,1704364311,1704422924,1704595732,172808,TIMEOUT
5324761_2,36,1,1704364311,1704422954,1704537987,115033,COMPLETED
5324761_3,36,1,1704364311,1704423314,1704519143,95829,COMPLETED
5324763_1,36,1,1704364632,1704426650,1704599452,172802,TIMEOUT
5324763_2,36,1,1704364632,1704427671,1704600472,172801,TIMEOUT
5324763_3,36,1,1704364632,1704428512,1704601312,172800,TIMEOUT
5324764_1,36,1,1704364789,1704432057,1704604882,172825,TIMEOUT
5324764_2,36,1,1704364789,1704432057,1704604882,172825,TIMEOUT
5324764_3,36,1,1704364789,1704434099,1704606923,172824,TIMEOUT
5324765_1,36,1,1704365274,1704434099,1704606923,172824,TIMEOUT
5324765_2,36,1,1704365274,1704437072,1704609893,172821,TIMEOUT
5324765_3,36,1,1704365274,1704451593,1704624413,172820,TIMEOUT
5324766_1,36,1,1704365404,1704454749,1704627563,172814,TIMEOUT
5324766_2,36,1,1704365404,1704455350,1704628163,172813,TIMEOUT
5324766_3,36,1,1704365404,1704455471,1704628283,172812,TIMEOUT
5324767_1,36,1,1704365469,1704456643,1704629453,172810,TIMEOUT
5324767_2,36,1,1704365469,1704456643,1704629453,172810,TIMEOUT
5324767_3,36,1,1704365469,1704456884,1704629693,172809,TIMEOUT
5324768,36,1,1704365889,1704365889,1704365892,3,FAILED
5324769,36,1,1704365956,1704365956,1704452378,86422,TIMEOUT
5324770,1,1,1704366502,None,1704366691,0,CANCELLED by 46357
5324771,1,1,1704366525,None,1704366528,0,CANCELLED by 6992
5324772,36,1,1704366543,1704370970,1704372979,2009,FAILED
5324773,36,1,1704366570,1704366645,1704409866,43221,TIMEOUT
5324775,36,1,1704366712,1704366712,1704366773,61,FAILED
5324776,72,2,1704366935,1704366951,1704366988,37,COMPLETED
5324777,72,2,1704367025,1704367042,1704367074,32,COMPLETED
5324778,144,4,1704367204,None,1704367329,0,CANCELLED by 45900
5324779,72,2,1704367343,1704367372,1704367397,25,COMPLETED
5324780_1,36,1,1704367386,1704370992,1704509277,138285,COMPLETED
5324780_2,36,1,1704367386,1704371750,1704496867,125117,COMPLETED
5324780_3,36,1,1704367386,1704371750,1704371924,174,COMPLETED
5324781_1,36,1,1704367386,1704371750,1704393855,22105,COMPLETED
5324781_2,36,1,1704367386,1704371830,1704391403,19573,COMPLETED
5324781_3,36,1,1704367386,1704371830,1704393643,21813,COMPLETED
5324782_1,36,1,1704367386,1704371835,1704416998,45163,COMPLETED
5324782_2,36,1,1704367386,1704371835,1704392566,20731,COMPLETED
5324782_3,36,1,1704367386,1704371925,1704394127,22202,COMPLETED
5324783_1,36,1,1704367386,1704372719,1704573026,200307,COMPLETED
5324783_2,36,1,1704367386,1704372719,1704507840,135121,COMPLETED
5324783_3,36,1,1704367386,1704372719,1704383441,10722,COMPLETED
5324784_1,36,1,1704367386,1704372719,1704631943,259224,TIMEOUT
5324784_2,36,1,1704367386,1704372719,1704546730,174011,COMPLETED
5324784_3,36,1,1704367386,1704372719,1704458108,85389,COMPLETED
5324785_1,36,1,1704367386,1704372719,1704545631,172912,COMPLETED
5324785_2,36,1,1704367386,1704372720,1704400909,28189,COMPLETED
5324785_3,36,1,1704367386,1704373993,1704442333,68340,COMPLETED
5324786_1,36,1,1704367386,1704373993,1704633203,259210,TIMEOUT
5324786_2,36,1,1704367386,1704373993,1704452423,78430,COMPLETED
5324786_3,36,1,1704367386,1704373993,1704468043,94050,COMPLETED
5324787_1,36,1,1704367386,1704376198,1704389865,13667,COMPLETED
5324787_2,36,1,1704367386,1704376354,1704434097,57743,COMPLETED
5324787_3,36,1,1704367386,1704376354,1704379992,3638,COMPLETED
5324788_1,36,1,1704367386,1704376354,1704635574,259220,TIMEOUT
5324788_2,36,1,1704367386,1704376354,1704383013,6659,COMPLETED
5324788_3,36,1,1704367386,1704376354,1704635574,259220,TIMEOUT
5324789_1,36,1,1704367386,1704376371,1704393824,17453,COMPLETED
5324789_2,36,1,1704367386,1704376626,1704487211,110585,COMPLETED
5324789_3,36,1,1704367386,1704376626,1704393808,17182,COMPLETED
5324790_1,36,1,1704367386,1704376668,1704379178,2510,COMPLETED
5324790_2,36,1,1704367386,1704378568,1704637794,259226,TIMEOUT
5324790_3,36,1,1704367386,1704378710,1704383347,4637,COMPLETED
5324791_1,36,1,1704367386,1704378770,1704404471,25701,COMPLETED
5324791_2,36,1,1704367386,1704379193,1704638394,259201,TIMEOUT
5324791_3,36,1,1704367386,1704379374,1704638574,259200,TIMEOUT
5324792_1,36,1,1704367386,1704379627,1704516095,136468,COMPLETED
5324792_2,36,1,1704367386,1704379627,1704638844,259217,TIMEOUT
5324792_3,36,1,1704367386,1704379627,1704638844,259217,TIMEOUT
5324793_1,36,1,1704367386,1704379627,1704515825,136198,COMPLETED
5324793_2,36,1,1704367386,1704379627,1704383872,4245,COMPLETED
5324793_3,36,1,1704367386,1704379627,1704404051,24424,COMPLETED
5324794_1,36,1,1704367386,1704379627,1704408294,28667,COMPLETED
5324794_2,36,1,1704367386,1704379644,1704391021,11377,COMPLETED
5324794_3,36,1,1704367386,1704379644,1704448425,68781,COMPLETED
5324795_1,36,1,1704367386,1704380673,1704442408,61735,COMPLETED
5324795_2,36,1,1704367386,1704380674,1704396593,15919,COMPLETED
5324795_3,36,1,1704367386,1704380674,1704394937,14263,COMPLETED
5324796_1,36,1,1704367386,1704380674,1704525594,144920,COMPLETED
5324796_2,36,1,1704367386,1704383839,1704419777,35938,COMPLETED
5324796_3,36,1,1704367386,1704383839,1704607574,223735,COMPLETED
5324797_1,36,1,1704367386,1704383839,1704473898,90059,COMPLETED
5324797_2,36,1,1704367386,1704383848,1704540179,156331,COMPLETED
5324797_3,36,1,1704367386,1704383848,1704525389,141541,COMPLETED
5324798_1,36,1,1704367386,1704383873,1704643074,259201,TIMEOUT
5324798_2,36,1,1704367386,1704383881,1704643104,259223,TIMEOUT
5324798_3,36,1,1704367386,1704384019,1704390961,6942,COMPLETED
5324799_1,36,1,1704367386,1704384019,1704444883,60864,COMPLETED
5324799_2,36,1,1704367386,1704384028,1704643254,259226,TIMEOUT
5324799_3,36,1,1704367386,1704384028,1704643254,259226,TIMEOUT
5324800_1,36,1,1704367386,1704384352,1704385181,829,COMPLETED
5324800_2,36,1,1704367386,1704384352,1704399190,14838,COMPLETED
5324800_3,36,1,1704367386,1704384352,1704398981,14629,COMPLETED
5324801_1,36,1,1704367386,1704384352,1704643554,259202,TIMEOUT
5324801_2,36,1,1704367386,1704384872,1704644094,259222,TIMEOUT
5324801_3,36,1,1704367386,1704384872,1704644094,259222,TIMEOUT
5324802_1,36,1,1704367386,1704384901,1704644124,259223,TIMEOUT
5324802_2,36,1,1704367386,1704384901,1704474728,89827,COMPLETED
5324802_3,36,1,1704367386,1704384972,1704644184,259212,TIMEOUT
5324803_1,36,1,1704367386,1704384976,1704409760,24784,COMPLETED
5324803_2,36,1,1704367386,1704385001,1704420844,35843,COMPLETED
5324803_3,36,1,1704367386,1704385001,1704463091,78090,FAILED
5324804_1,36,1,1704367386,1704385212,1704435468,50256,COMPLETED
5324804_2,36,1,1704367386,1704386033,1704403767,17734,COMPLETED
5324804_3,36,1,1704367386,1704386033,1704469268,83235,COMPLETED
5324805_1,36,1,1704367386,1704386039,1704417968,31929,COMPLETED
5324805_2,36,1,1704367386,1704386040,1704457749,71709,COMPLETED
5324805_3,36,1,1704367386,1704386471,1704446372,59901,COMPLETED
5324806_1,36,1,1704367386,1704386471,1704409828,23357,COMPLETED
5324806_2,36,1,1704367386,1704386479,1704408986,22507,COMPLETED
5324806_3,36,1,1704367386,1704386479,1704418890,32411,COMPLETED
5324807_1,36,1,1704367386,1704388231,1704647454,259223,TIMEOUT
5324807_2,36,1,1704367386,1704388231,1704590616,202385,COMPLETED
5324807_3,36,1,1704367386,1704388231,1704578137,189906,COMPLETED
5324808_1,36,1,1704367387,1704388303,1704469578,81275,COMPLETED
5324808_2,36,1,1704367387,1704388303,1704487536,99233,COMPLETED
5324808_3,36,1,1704367387,1704388303,1704487274,98971,COMPLETED
5324809_1,36,1,1704367387,1704388303,1704448351,60048,COMPLETED
5324809_2,36,1,1704367387,1704388872,1704434795,45923,COMPLETED
5324809_3,36,1,1704367387,1704389122,1704445241,56119,COMPLETED
5324810_1,72,2,1704367387,1704390040,1704411008,20968,COMPLETED
5324810_2,72,2,1704367387,1704390040,1704649254,259214,TIMEOUT
5324810_3,72,2,1704367387,1704390545,1704649764,259219,TIMEOUT
5324811_1,72,2,1704367387,1704393088,1704652314,259226,TIMEOUT
5324811_2,72,2,1704367387,1704393858,1704453996,60138,COMPLETED
5324811_3,72,2,1704367387,1704395027,1704654234,259207,TIMEOUT
5324812_1,72,2,1704367387,1704400911,1704660114,259203,TIMEOUT
5324812_2,72,2,1704367387,1704411010,1704524860,113850,COMPLETED
5324812_3,72,2,1704367387,1704434529,1704466865,32336,COMPLETED
5324813_1,72,2,1704367387,1704435469,1704475476,40007,COMPLETED
5324813_2,72,2,1704367387,1704436889,1704696117,259228,TIMEOUT
5324813_3,72,2,1704367387,1704438603,1704697828,259225,TIMEOUT
5324814_1,72,2,1704367387,1704440314,1704616009,175695,COMPLETED
5324814_2,72,2,1704367387,1704442409,1704701638,259229,TIMEOUT
5324814_3,72,2,1704367387,1704446647,1704562958,116311,COMPLETED
5324815_1,72,2,1704367387,1704447107,1704511019,63912,COMPLETED
5324815_2,72,2,1704367387,1704449680,1704708899,259219,TIMEOUT
5324815_3,72,2,1704367387,1704452740,1704534713,81973,COMPLETED
5324816_1,36,1,1704367387,1704390545,1704392505,1960,COMPLETED
5324816_2,36,1,1704367387,1704390963,1704394242,3279,COMPLETED
5324816_3,36,1,1704367387,1704391023,1704393417,2394,COMPLETED
5324817_1,36,1,1704367387,1704391404,1704417278,25874,COMPLETED
5324817_2,36,1,1704367387,1704393419,1704419009,25590,COMPLETED
5324817_3,36,1,1704367387,1704393706,1704406150,12444,COMPLETED
5324818_1,36,1,1704367387,1704393810,1704393857,47,COMPLETED
5324818_2,36,1,1704367387,1704393825,1704393857,32,COMPLETED
5324818_3,36,1,1704367387,1704393856,1704393878,22,COMPLETED
5324819_1,36,1,1704367387,1704393879,1704534973,141094,COMPLETED
5324819_2,36,1,1704367387,1704394129,1704446646,52517,COMPLETED
5324819_3,36,1,1704367387,1704396595,1704655824,259229,TIMEOUT
5324820_2,36,1,1704367387,1704401498,1704660714,259216,TIMEOUT
5324820_3,36,1,1704367387,1704403768,1704521945,118177,COMPLETED
5324821_1,36,1,1704367387,1704404053,1704438602,34549,COMPLETED
5324821_2,36,1,1704367387,1704404472,1704440313,35841,COMPLETED
5324821_3,36,1,1704367387,1704406151,1704509649,103498,COMPLETED
5324822_1,36,1,1704367387,1704408296,1704667525,259229,TIMEOUT
5324822_2,36,1,1704367387,1704408987,1704423903,14916,COMPLETED
5324822_3,36,1,1704367387,1704409762,1704436888,27126,COMPLETED
5324823_1,36,1,1704367387,1704409830,1704428923,19093,COMPLETED
5324823_2,36,1,1704367387,1704416999,1704436683,19684,COMPLETED
5324823_3,36,1,1704367387,1704417279,1704430973,13694,COMPLETED
5324824_1,36,1,1704367387,1704417969,1704677186,259217,TIMEOUT
5324824_2,36,1,1704367387,1704418891,1704429083,10192,COMPLETED
5324824_3,36,1,1704367387,1704419011,1704482356,63345,COMPLETED
5324825_1,36,1,1704367387,1704419779,1704429198,9419,COMPLETED
5324825_2,36,1,1704367387,1704420845,1704420854,9,COMPLETED
5324825_3,36,1,1704367387,1704420855,1704429760,8905,COMPLETED
5324826_1,36,1,1704367387,1704423904,1704446198,22294,COMPLETED
5324826_2,36,1,1704367387,1704428925,1704437157,8232,COMPLETED
5324826_3,36,1,1704367387,1704429084,1704688286,259202,TIMEOUT
5324827_1,36,1,1704367387,1704429199,1704434528,5329,COMPLETED
5324827_2,36,1,1704367387,1704429761,1704440306,10545,COMPLETED
5324827_3,36,1,1704367387,1704430974,1704690176,259202,TIMEOUT
